"","date","countrycode","population","cases","deaths","cases_prev_week","deaths_prev_week","cases_infected","cum_deaths","cases_contagious","cases_active","p_cases_infected","p_cases","p_cases_contagious","p_cases_active"
"4569","2020/03/09","BD",163046173,3,0,3,0,3,0,3,3,1.83996958947328e-08,1.83996958947328e-08,1.83996958947328e-08,1.83996958947328e-08
"4568","2020/03/15","BD",163046173,0,0,3,0,3,0,3,3,1.83996958947328e-08,0,1.83996958947328e-08,1.83996958947328e-08
"4567","2020/03/17","BD",163046173,2,0,5,0,5,0,5,5,3.06661598245547e-08,1.22664639298219e-08,3.06661598245547e-08,3.06661598245547e-08
"4566","2020/03/18","BD",163046173,3,0,8,0,8,0,8,8,4.90658557192876e-08,1.83996958947328e-08,4.90658557192876e-08,4.90658557192876e-08
"4565","2020/03/19","BD",163046173,2,0,10,0,10,0,10,10,6.13323196491095e-08,1.22664639298219e-08,6.13323196491095e-08,6.13323196491095e-08
"4564","2020/03/20","BD",163046173,0,0,10,0,10,0,10,10,6.13323196491095e-08,0,6.13323196491095e-08,6.13323196491095e-08
"4563","2020/03/21","BD",163046173,7,0,17,0,17,0,17,17,1.04264943403486e-07,4.29326237543766e-08,1.04264943403486e-07,1.04264943403486e-07
"4562","2020/03/22","BD",163046173,7,2,21,2,24,2,24,24,1.47197567157863e-07,4.29326237543766e-08,1.47197567157863e-07,1.47197567157863e-07
"4561","2020/03/23","BD",163046173,3,1,24,3,27,3,27,27,1.65597263052596e-07,1.83996958947328e-08,1.65597263052596e-07,1.65597263052596e-07
"4560","2020/03/24","BD",163046173,6,0,28,3,33,3,33,33,2.02396654842061e-07,3.67993917894657e-08,2.02396654842061e-07,2.02396654842061e-07
"4559","2020/03/25","BD",163046173,6,1,31,4,39,4,39,39,2.39196046631527e-07,3.67993917894657e-08,2.39196046631527e-07,2.39196046631527e-07
"4558","2020/03/26","BD",163046173,0,1,29,5,39,5,39,39,2.39196046631527e-07,0,2.39196046631527e-07,2.39196046631527e-07
"4557","2020/03/27","BD",163046173,9,0,38,5,48,5,45,48,2.94395134315725e-07,5.51990876841985e-08,2.75995438420993e-07,2.94395134315725e-07
"4556","2020/03/28","BD",163046173,0,0,31,5,48,5,45,48,2.94395134315725e-07,0,2.75995438420993e-07,2.94395134315725e-07
"4555","2020/03/29","BD",163046173,0,0,24,3,48,5,43,48,2.94395134315725e-07,0,2.63728974491171e-07,2.94395134315725e-07
"4554","2020/03/30","BD",163046173,1,0,22,2,49,5,41,49,3.00528366280636e-07,6.13323196491095e-09,2.51462510561349e-07,3.00528366280636e-07
"4553","2020/03/31","BD",163046173,0,0,16,2,49,5,39,49,3.00528366280636e-07,0,2.39196046631527e-07,3.00528366280636e-07
"4552","2020/04/01","BD",163046173,2,0,12,1,51,5,41,51,3.12794830210458e-07,1.22664639298219e-08,2.51462510561349e-07,3.12794830210458e-07
"4551","2020/04/02","BD",163046173,3,1,15,1,54,6,37,51,3.31194526105191e-07,1.83996958947328e-08,2.26929582701705e-07,3.12794830210458e-07
"4550","2020/04/03","BD",163046173,2,0,8,1,56,6,32,53,3.43460990035013e-07,1.22664639298219e-08,1.9626342287715e-07,3.2506129414028e-07
"4549","2020/04/04","BD",163046173,5,0,13,1,61,6,34,56,3.74127149859568e-07,3.06661598245547e-08,2.08529886806972e-07,3.43460990035013e-07
"4548","2020/04/05","BD",163046173,9,2,22,3,70,8,37,62,4.29326237543766e-07,5.51990876841985e-08,2.26929582701705e-07,3.80260381824479e-07
"4547","2020/04/06","BD",163046173,18,1,39,4,88,9,49,78,5.39724412912163e-07,1.10398175368397e-07,3.00528366280636e-07,4.78392093263054e-07
"4546","2020/04/07","BD",163046173,35,3,74,7,123,12,84,113,7.54387531684046e-07,2.14663118771883e-07,5.15191485052519e-07,6.93055212034937e-07
"4545","2020/04/08","BD",163046173,41,5,113,12,164,17,116,147,1.0058500422454e-06,2.51462510561349e-07,7.1145490792967e-07,9.01585098841909e-07
"4544","2020/04/09","BD",163046173,54,3,164,14,218,20,170,194,1.33704456835059e-06,3.31194526105191e-07,1.04264943403486e-06,1.18984700119272e-06
"4543","2020/04/10","BD",163046173,112,1,274,15,330,21,282,303,2.02396654842061e-06,6.86921980070026e-07,1.72957141410489e-06,1.85836928536802e-06
"4542","2020/04/11","BD",163046173,94,6,363,21,424,27,375,391,2.60049035312224e-06,5.76523804701629e-07,2.2999619868416e-06,2.39809369828018e-06
"4541","2020/04/12","BD",163046173,58,3,412,22,482,30,433,443,2.95621780708708e-06,3.55727453964835e-07,2.65568944080644e-06,2.71702176045555e-06
"4540","2020/04/13","BD",163046173,139,4,533,25,621,34,570,582,3.8087370502097e-06,8.52519243122621e-07,3.49594221999924e-06,3.56954100357817e-06
"4539","2020/04/14","BD",163046173,182,5,680,27,803,39,749,755,4.92498526782349e-06,1.11624821761379e-06,4.5937907417183e-06,4.63059013350776e-06
"4538","2020/04/15","BD",163046173,209,7,848,29,1012,46,956,964,6.20683074848988e-06,1.28184548066639e-06,5.86336975845486e-06,5.91243561417415e-06
"4537","2020/04/16","BD",163046173,219,4,1013,30,1231,50,1170,1183,7.55000854880537e-06,1.3431778003155e-06,7.17588139894581e-06,7.25561341448965e-06
"4536","2020/04/17","BD",163046173,341,10,1242,39,1572,60,1502,1523,9.64144064884001e-06,2.09143210003463e-06,9.21211441129624e-06,9.34091228255937e-06
"4535","2020/04/18","BD",163046173,266,15,1414,48,1838,75,1750,1789,1.12728803515063e-05,1.63143970266631e-06,1.07331559385942e-05,1.09723519852257e-05
"4534","2020/04/19","BD",163046173,306,9,1662,54,2144,84,2021,2093,1.31496493327691e-05,1.87676898126275e-06,1.2395261801085e-05,1.28368545025586e-05
"4533","2020/04/20","BD",163046173,312,7,1835,57,2456,91,2292,2402,1.50632177058213e-05,1.91356837305222e-06,1.40573676635759e-05,1.47320231797161e-05
"4532","2020/04/21","BD",163046173,492,10,2145,62,2948,101,2730,2892,1.80807678325575e-05,3.01755012673619e-06,1.67437232642069e-05,1.77373068425225e-05
"4531","2020/04/22","BD",163046173,434,9,2370,64,3382,110,3052,3321,2.07425905053288e-05,2.66182267277135e-06,1.87186239569082e-05,2.03684633554693e-05
"4530","2020/04/23","BD",163046173,390,10,2541,70,3772,120,3348,3702,2.31345509716441e-05,2.39196046631527e-06,2.05340606185218e-05,2.27052247341003e-05
"4529","2020/04/24","BD",163046173,414,7,2614,67,4186,127,3704,4098,2.56737090051172e-05,2.53915803347313e-06,2.27174911980301e-05,2.51339845922051e-05
"4528","2020/04/25","BD",163046173,503,4,2851,56,4689,131,4068,4566,2.87587246834674e-05,3.08501567835021e-06,2.49499876332577e-05,2.80043371517834e-05
"4527","2020/04/26","BD",163046173,309,9,2854,56,4998,140,4195,4834,3.06538933606249e-05,1.89516867715748e-06,2.57289080928014e-05,2.96480433183795e-05
"4526","2020/04/27","BD",163046173,418,5,2960,54,5416,145,4404,5198,3.32175843219577e-05,2.56369096133278e-06,2.70107535734678e-05,3.18805397536071e-05
"4525","2020/04/28","BD",163046173,497,7,2965,51,5913,152,4682,5583,3.62658006085184e-05,3.04821628656074e-06,2.8715792059713e-05,3.42418340600978e-05
"4524","2020/04/29","BD",163046173,549,3,3080,45,6462,155,4890,6038,3.96329449572545e-05,3.36714434873611e-06,2.99915043084145e-05,3.70324546041323e-05
"4523","2020/04/30","BD",163046173,641,8,3331,43,7103,163,5265,6621,4.35643466467624e-05,3.93140168950792e-06,3.22914662952561e-05,4.06081288396754e-05
"4522","2020/05/01","BD",163046173,564,5,3481,41,7667,168,5523,7046,4.70234894749722e-05,3.45914282820977e-06,3.38738401422032e-05,4.32147524247625e-05
"4521","2020/05/02","BD",163046173,571,2,3549,39,8238,170,5782,7435,5.05255649269364e-05,3.50207545196415e-06,3.54623472211151e-05,4.56005796591129e-05
"4520","2020/05/03","BD",163046173,552,5,3792,35,8790,175,5842,7778,5.39111089715672e-05,3.38554404463084e-06,3.58303411390097e-05,4.77042782230773e-05
"4519","2020/05/04","BD",163046173,665,2,4039,32,9455,177,6073,8224,5.7989708228233e-05,4.07859925666578e-06,3.72471177229042e-05,5.04396996794276e-05
"4518","2020/05/05","BD",163046173,688,5,4230,30,10143,182,6371,8571,6.22093718200917e-05,4.21966359185873e-06,3.90748208484476e-05,5.25679311712517e-05
"4517","2020/05/06","BD",163046173,786,1,4467,28,10929,183,6743,9091,6.70300921445117e-05,4.82072032442e-06,4.13563831393945e-05,5.57572117930054e-05
"4516","2020/05/07","BD",163046173,790,3,4616,23,11719,186,7030,9575,7.18753453967914e-05,4.84525325227965e-06,4.31166207133239e-05,5.87256960640223e-05
"4515","2020/05/08","BD",163046173,706,13,4758,31,12425,199,7427,9969,7.62054071640185e-05,4.33006176722713e-06,4.55515138033936e-05,6.11421894581972e-05
"4514","2020/05/09","BD",163046173,709,7,4896,36,13134,206,7718,10186,8.05538686271404e-05,4.34846146312186e-06,4.73362843051827e-05,6.24731007945829e-05
"4513","2020/05/10","BD",163046173,636,8,4980,39,13770,214,7857,10388,8.44546041568237e-05,3.90073552968336e-06,4.81888035483053e-05,6.37120136514949e-05
"4512","2020/05/11","BD",163046173,887,14,5202,51,14657,228,8195,10885,8.98947809096997e-05,5.44017675287601e-06,5.02618359524452e-05,6.67602299380556e-05
"4511","2020/05/12","BD",163046173,1034,11,5548,57,15691,239,8588,11505,9.62365427614177e-05,6.34176185171792e-06,5.26721961146552e-05,7.05628337563004e-05
"4510","2020/05/13","BD",163046173,969,11,5731,67,16660,250,8993,11971,0.000102179644535416,5.94310177399871e-06,5.51561550604441e-05,7.34209198519489e-05
"4509","2020/05/14","BD",163046173,1162,19,6103,83,17822,269,9584,12824,0.000109306460078643,7.12681554322652e-06,5.87808951517065e-05,7.8652566718018e-05
"4508","2020/05/15","BD",163046173,1041,14,6438,84,18863,283,10073,13447,0.000115691154554115,6.38469447547229e-06,6.1780045582548e-05,8.24735702321575e-05
"4507","2020/05/16","BD",163046173,1202,15,6931,92,20065,298,10610,14152,0.000123063299375938,7.37214482182296e-06,6.50735911477051e-05,8.67974987674197e-05
"4506","2020/05/17","BD",163046173,930,16,7225,100,20995,314,10852,14533,0.000128767205103305,5.70390572736718e-06,6.65578332832136e-05,8.91342601460508e-05
"4505","2020/05/18","BD",163046173,1273,14,7611,100,22268,328,11339,15165,0.000136574809394637,7.80760429133163e-06,6.95447172501252e-05,9.30104627478745e-05
"4504","2020/05/19","BD",163046173,1602,21,8179,110,23870,349,12151,16203,0.000146400247002424,9.82543760778733e-06,7.45249016056329e-05,9.93767575274521e-05
"4503","2020/05/20","BD",163046173,1251,21,8461,120,25121,370,12696,16883,0.000154072920190528,7.67267318810359e-06,7.78675130265094e-05,0.000103547355263591
"4502","2020/05/21","BD",163046173,1617,16,8916,117,26738,386,13604,17948,0.000163990356277789,9.917436087261e-06,8.34364876506485e-05,0.000110079247306222
"4501","2020/05/22","BD",163046173,1773,22,9648,125,28511,408,14741,19056,0.000174864576551576,1.08742202737871e-05,9.04099723947523e-05,0.000116874868323343
"4500","2020/05/23","BD",163046173,1694,24,10140,134,30205,432,15548,20062,0.000185254271500135,1.03896949485591e-05,9.53594905904354e-05,0.000123044899680043
"4499","2020/05/24","BD",163046173,1873,20,11083,138,32078,452,16387,21149,0.000196741814970413,1.14875434702782e-05,0.000100505272208996,0.000129711722825902
"4498","2020/05/25","BD",163046173,1532,28,11342,152,33610,480,16950,21891,0.000206137926340657,9.39611137024357e-06,0.000103958281805241,0.000134262580943866
"4497","2020/05/26","BD",163046173,1975,21,11715,152,35585,501,17763,23160,0.000218251059471356,1.21131331306991e-05,0.000108944599392713,0.000142045652307337
"4496","2020/05/27","BD",163046173,1166,21,11630,152,36751,522,17888,23617,0.000225402407942442,7.15134847108616e-06,0.000109711253388327,0.000144848539315302
"4495","2020/05/28","BD",163046173,1541,22,11554,158,38292,544,18227,24522,0.00023485371840037,9.45131045792777e-06,0.000111790419024432,0.000150399114243546
"4494","2020/05/29","BD",163046173,2029,15,11810,151,40321,559,19326,25664,0.000247298046057174,1.24443276568043e-05,0.000118530840953869,0.000157403265147475
"4493","2020/05/30","BD",163046173,2523,23,12639,150,42844,582,20576,27153,0.000262772190304645,1.54741442474703e-05,0.000126197380910008,0.000166535647543227
"4492","2020/05/31","BD",163046173,1764,28,12530,158,44608,610,20738,27948,0.000273591211490747,1.08190211861029e-05,0.000127190964488323,0.000171411566955331
"4491","2020/06/01","BD",163046173,2545,40,13543,170,47153,650,22032,29331,0.000289200286841446,1.56090753506984e-05,0.000135127366650918,0.000179893826762803
"4490","2020/06/02","BD",163046173,2381,22,13949,171,49534,672,22796,30671,0.000303803512149899,1.4603225308453e-05,0.00013981315587211,0.000188112357595784
"4489","2020/06/03","BD",163046173,2911,37,15694,187,52445,709,23934,32380,0.000321657350399755,1.78538382498558e-05,0.000146792773848179,0.000198594051023816
"4488","2020/06/04","BD",163046173,2695,37,16848,202,55140,746,24935,34145,0.00033818641054519,1.6529060145435e-05,0.000152932139045054,0.000209419205441884
"4487","2020/06/05","BD",163046173,2423,35,17242,222,57563,781,25485,35295,0.000353047231596169,1.48608210509792e-05,0.000156305416625755,0.000216472422201532
"4486","2020/06/06","BD",163046173,2828,30,17547,229,60391,811,26781,36521,0.000370392011592937,1.73447799967682e-05,0.00016425408525228,0.000223991764590513
"4485","2020/06/07","BD",163046173,2635,35,18418,236,63026,846,27441,37905,0.000386553077820477,1.61610662275403e-05,0.000168302018349121,0.000232480157629949
"4484","2020/06/08","BD",163046173,2743,42,18616,238,65769,888,29018,39031,0.000403376533100228,1.68234552797507e-05,0.000177974125157786,0.000239386176822439
"4483","2020/06/09","BD",163046173,2735,42,18970,258,68504,930,30212,39993,0.000420150922524259,1.67743894240314e-05,0.000185297204123889,0.000245286345972683
"4482","2020/06/10","BD",163046173,3171,45,19230,266,71675,975,31354,41470,0.000439599401084992,1.94484785607326e-05,0.000192301355027818,0.000254345129584857
"4481","2020/06/11","BD",163046173,3190,37,19725,266,74865,1012,32021,42787,0.000459164411053058,1.95650099680659e-05,0.000196392220748413,0.000262422596082645
"4480","2020/06/12","BD",163046173,3187,37,20489,268,78052,1049,33444,44442,0.000478711021325229,1.95466102721712e-05,0.000205119809834482,0.000272573094984572
"4479","2020/06/13","BD",163046173,3471,46,21132,284,81523,1095,34370,45938,0.000499999469475435,2.12884481502059e-05,0.000210799182633989,0.000281748410004079
"4478","2020/06/14","BD",163046173,2856,44,21353,293,84379,1139,34845,47628,0.000517515979967221,1.75165104917857e-05,0.000213712467817322,0.000292113572024779
"4477","2020/06/15","BD",163046173,3141,32,21751,283,87520,1171,35075,49228,0.000536780461569006,1.92644816017853e-05,0.000215123111169251,0.000301926743168636
"4476","2020/06/16","BD",163046173,3099,38,22115,279,90619,1209,35479,50298,0.000555787347428265,1.9006885859259e-05,0.000217600936883075,0.000308489301371091
"4475","2020/06/17","BD",163046173,3862,53,22806,287,94481,1262,36918,51637,0.000579473889276751,2.36865418484861e-05,0.000226426657680582,0.000316701698972107
"4474","2020/06/18","BD",163046173,4008,43,23624,293,98489,1305,38098,53881,0.000604055882992114,2.45819937153631e-05,0.000233663871399177,0.000330464671501367
"4473","2020/06/19","BD",163046173,3803,38,24240,294,102292,1343,39266,55139,0.00062738056415467,2.33246811625563e-05,0.000240827486334193,0.000338180277313225
"4472","2020/06/20","BD",163046173,3243,45,24012,293,105535,1388,39766,56001,0.000647270635416877,1.98900712622062e-05,0.000243894102316649,0.000343467123266978
"4471","2020/06/21","BD",163046173,3240,37,24396,286,108775,1425,40271,56330,0.000667142306983188,1.98716715663115e-05,0.000246991384458929,0.000345484956583434
"4470","2020/06/22","BD",163046173,3531,39,24786,293,112306,1464,40631,57166,0.000688798749051289,2.16564420681006e-05,0.000249199347966297,0.000350612338506099
"4469","2020/06/23","BD",163046173,3480,38,25167,293,115786,1502,40921,58223,0.000710142396289179,2.13436472378901e-05,0.000250977985236121,0.00035709516469301
"4468","2020/06/24","BD",163046173,3412,43,24717,283,119198,1545,41146,58807,0.000731068983753455,2.09265874642761e-05,0.000252357962428226,0.000360676972160518
"4467","2020/06/25","BD",163046173,3462,37,24171,277,122660,1582,41137,59634,0.000752302232815977,2.12332490625217e-05,0.000252302763340542,0.000365749154995499
"4466","2020/06/26","BD",163046173,3946,39,24314,278,126606,1621,42227,60837,0.000776503966149515,2.42017333335386e-05,0.000258987986182294,0.000373127433049287
"4465","2020/06/27","BD",163046173,3868,40,24939,273,130474,1661,42954,61970,0.000800227307389791,2.37233412402755e-05,0.000263446845820785,0.000380076384865531
"4464","2020/06/28","BD",163046173,3504,34,25203,270,133978,1695,43359,62303,0.000821718152194839,2.1490844805048e-05,0.000265930804766574,0.000382118751109847
"4463","2020/06/29","BD",163046173,3809,43,25481,274,137787,1738,43306,62922,0.000845079632749185,2.33614805543458e-05,0.000265605743472433,0.000385915221696127
"4462","2020/06/30","BD",163046173,4014,45,26015,281,141801,1783,43312,63749,0.000869698425856337,2.46187931071525e-05,0.000265642542864223,0.000390987404531108
"4461","2020/07/01","BD",163046173,3682,64,26285,302,145483,1847,43191,63960,0.000892280985951139,2.25825600948021e-05,0.000264900421796469,0.000392281516475704
"4460","2020/07/02","BD",163046173,3775,41,26598,306,149258,1888,43723,64879,0.000915433936618678,2.31529506675388e-05,0.000268163301201801,0.000397917956651457
"4459","2020/07/03","BD",163046173,4019,38,26671,305,153277,1926,44502,65757,0.000940083395885655,2.46494592669771e-05,0.000272941088902467,0.000403302934316649
"4458","2020/07/04","BD",163046173,3114,42,25917,307,156391,1968,44085,65772,0.000959182280224388,1.90988843387327e-05,0.000270383531173099,0.000403394932796123
"4457","2020/07/05","BD",163046173,3288,29,25701,302,159679,1997,43893,65198,0.000979348346925015,2.01660667006272e-05,0.000269205950635836,0.000399874457648264
"4456","2020/07/06","BD",163046173,2738,55,24630,314,162417,2052,43219,63928,0.000996141136044941,1.67927891199262e-05,0.000265072152291486,0.000392085253052827
"4455","2020/07/07","BD",163046173,3201,44,23817,313,165618,2096,42958,63326,0.00101577361156462,1.96324755196799e-05,0.000263471378748644,0.000388393047409951
"4454","2020/07/08","BD",163046173,3027,55,23162,304,168645,2151,42039,63110,0.00103433890472241,1.85652931577854e-05,0.000257834938572891,0.00038706826930553
"4453","2020/07/09","BD",163046173,3489,46,22876,309,172134,2197,41660,63359,0.00105573775104798,2.13988463255743e-05,0.00025551044365819,0.000388595444064793
"4452","2020/07/10","BD",163046173,3360,41,22217,312,175494,2238,41516,63188,0.00107634541045008,2.06076594021008e-05,0.000254627258255243,0.000387546661398793
"4451","2020/07/11","BD",163046173,2949,37,22052,307,178443,2275,40656,62657,0.0010944323115146,1.80869010645224e-05,0.000249352678765419,0.000384289915225425
"4450","2020/07/12","BD",163046173,2686,30,21450,308,181129,2305,39328,61931,0.00111090617257235,1.64738610577508e-05,0.000241207746716018,0.0003798371888189
"4449","2020/07/13","BD",163046173,2666,47,21378,300,183795,2352,38312,61135,0.00112725736899081,1.63511964184526e-05,0.000234976383039668,0.000374955136174831
"4448","2020/07/14","BD",163046173,3099,39,21276,295,186894,2391,37636,60288,0.00114626425485007,1.9006885859259e-05,0.000230830318231388,0.000369760288700551
"4447","2020/07/15","BD",163046173,3163,33,21412,273,190057,2424,36780,59583,0.00116566366755508,1.93994127050133e-05,0.000225580271669425,0.000365436360165289
"4446","2020/07/16","BD",163046173,3533,33,21456,260,193590,2457,37199,59612,0.00118733237608711,2.16687085320304e-05,0.000228150095862722,0.000365614223892271
"4445","2020/07/17","BD",163046173,2733,39,20829,258,196323,2496,36644,58536,0.00120409449904721,1.67621229601016e-05,0.000224746152122197,0.000359014866298027
"4444","2020/07/18","BD",163046173,3034,51,20914,272,199357,2547,36940,57556,0.00122270272482875,1.86082257815398e-05,0.00022656158878381,0.000353004298972414
"4443","2020/07/19","BD",163046173,2709,34,20937,276,202066,2581,36448,56583,0.0012393176502217,1.66149253929438e-05,0.000223544038657074,0.000347036664270556
"4442","2020/07/20","BD",163046173,2459,37,20730,266,204525,2618,35880,55267,0.00125439926762341,1.5081617401716e-05,0.000220060362901005,0.000338965331004733
"4441","2020/07/21","BD",163046173,2928,50,20559,277,207453,2668,35319,54176,0.00127235737081667,1.79581031932592e-05,0.00021661961976869,0.000332273974931015
"4440","2020/07/22","BD",163046173,3057,41,20453,285,210510,2709,35016,54119,0.0012911066609334,1.87492901167328e-05,0.000214761250483322,0.000331924380709015
"4439","2020/07/23","BD",163046173,2744,42,19664,294,213254,2751,34811,53575,0.00130793624944512,1.68295885117156e-05,0.000213503937930515,0.000328587902520104
"4438","2020/07/24","BD",163046173,2856,50,19787,305,216110,2801,34981,53693,0.0013254527599369,1.75165104917857e-05,0.00021454658736455,0.000329311623891963
"4437","2020/07/25","BD",163046173,2548,35,19301,289,218658,2836,34863,53040,0.0013410802349835,1.56274750465931e-05,0.00021382286599269,0.000325306623418877
"4436","2020/07/26","BD",163046173,2520,38,19112,293,221178,2874,34284,52533,0.00135653597953507,1.54557445515756e-05,0.000210271724685007,0.000322197074812667
"4435","2020/07/27","BD",163046173,2275,54,18928,310,223453,2928,33396,51319,0.00137048908225525,1.39531027201724e-05,0.000204825414700166,0.000314751331207265
"4434","2020/07/28","BD",163046173,2772,37,18772,297,226225,2965,32635,50731,0.00138749040126198,1.70013190067331e-05,0.000200158025174869,0.000311144990811897
"4433","2020/07/29","BD",163046173,2960,35,18675,291,229185,3000,32862,50742,0.00140564476787812,1.81543666161364e-05,0.000201550268830903,0.000311212456363511
"4432","2020/07/30","BD",163046173,3009,35,18940,284,232194,3035,32837,51065,0.00142409966286053,1.8454894982417e-05,0.000201396938031781,0.000313193490288177
"4431","2020/07/31","BD",163046173,2695,48,18779,282,234889,3083,32823,51094,0.00144062872300597,1.6529060145435e-05,0.000201311072784272,0.00031337135401516
"4430","2020/08/01","BD",163046173,2772,28,19003,275,237661,3111,33136,50767,0.0014576300420127,1.70013190067331e-05,0.000203230774389289,0.000311365787162634
"4429","2020/08/02","BD",163046173,2199,21,18682,258,239860,3132,32407,49803,0.00147111701910354,1.34869770908392e-05,0.000198759648286869,0.00030545335154846
"4428","2020/08/03","BD",163046173,886,22,17293,226,240746,3154,30236,47156,0.00147655106262445,5.4340435209111e-06,0.000185444401691047,0.000289218686537341
"4427","2020/08/04","BD",163046173,1356,30,15877,219,242102,3184,28848,45779,0.00148486772516887,8.31666254441924e-06,0.000176931475723751,0.000280773226121658
"4426","2020/08/05","BD",163046173,1918,50,14835,234,244020,3234,27910,44663,0.00149663126407757,1.17635389086992e-05,0.000171178504140665,0.000273928539248818
"4425","2020/08/06","BD",163046173,2654,33,14480,232,246674,3267,28016,44608,0.00151290886171244,1.62775976348737e-05,0.000171828626728945,0.000273591211490747
"4424","2020/08/07","BD",163046173,2977,39,14762,223,249651,3306,28473,45126,0.00153116749327198,1.82586315595399e-05,0.000174631513736909,0.000276768225648571
"4423","2020/08/08","BD",163046173,2851,27,14841,222,252502,3333,29049,45049,0.00154865333760394,1.74858443319611e-05,0.000178164255348698,0.000276295966787273
"4422","2020/08/09","BD",163046173,2611,32,15253,233,255113,3365,28888,44603,0.00156466720626433,1.60138686603825e-05,0.000177176805002347,0.000273560545330923
"4421","2020/08/10","BD",163046173,2487,34,16854,245,257600,3399,28415,44346,0.00157992055416106,1.52533478967335e-05,0.000174275786282945,0.000271984304715941
"4420","2020/08/11","BD",163046173,2907,39,18405,254,260507,3438,28313,44397,0.00159774985948306,1.78293053219961e-05,0.000173650196622524,0.000272297099546151
"4419","2020/08/12","BD",163046173,2996,33,19483,237,263503,3471,28614,44845,0.00161612502244993,1.83751629668732e-05,0.000175496299443962,0.000275044787466431
"4418","2020/08/13","BD",163046173,2995,42,19824,246,266498,3513,28837,45320,0.00163449405218484,1.83690297349083e-05,0.000176864010172137,0.000277958072649764
"4417","2020/08/14","BD",163046173,2617,44,19464,251,269115,3557,29255,45662,0.00165054472023701,1.60506680521719e-05,0.00017942770113347,0.000280055637981764
"4416","2020/08/15","BD",163046173,2766,34,19379,258,271881,3591,31135,45656,0.00166750923985195,1.69645196149437e-05,0.000190958177227502,0.000280018838589974
"4415","2020/08/16","BD",163046173,2644,34,19412,260,274525,3625,32423,45340,0.00168372550516718,1.62162653152245e-05,0.000198857779998308,0.000278080737289062
"4414","2020/08/17","BD",163046173,2024,32,18949,258,276549,3657,32529,44355,0.00169613916666416,1.24136614969798e-05,0.000199507902586588,0.000272039503803625
"4413","2020/08/18","BD",163046173,2595,37,18637,256,279144,3694,32470,44255,0.0017120549036131,1.59157369489439e-05,0.000199146041900658,0.000271426180607134
"4412","2020/08/19","BD",163046173,3200,46,18841,269,282344,3740,32693,44683,0.00173168124590082,1.9626342287715e-05,0.000200513752628834,0.000274051203888116
"4411","2020/08/20","BD",163046173,2747,41,18593,268,285091,3781,32589,45231,0.00174852923410843,1.68479882076104e-05,0.000199875896504483,0.000277412215004887
"4410","2020/08/21","BD",163046173,2868,41,18844,265,287959,3822,32846,47213,0.00176611934338379,1.75901092753646e-05,0.000201452137119465,0.000289568280759341
"4409","2020/08/22","BD",163046173,2401,39,18479,270,290360,3861,32760,48258,0.00178084523333154,1.47258899477512e-05,0.000200924679170483,0.000295977508162672
"4408","2020/08/23","BD",163046173,2265,46,18100,282,292625,3907,32118,48605,0.00179473700373207,1.38917704005233e-05,0.00019698714424901,0.000298105739654497
"4407","2020/08/24","BD",163046173,1973,34,18049,284,294598,3941,31095,47924,0.00180683787039883,1.21008666667693e-05,0.000190712847948906,0.000293929008686392
"4406","2020/08/25","BD",163046173,2485,42,17939,289,297083,3983,30585,47432,0.00182207895183164,1.52410814328037e-05,0.000187584899646801,0.000290911458559656
"4405","2020/08/26","BD",163046173,2545,45,17284,288,299628,4028,30513,47126,0.00183768802718234,1.56090753506984e-05,0.000187143306945328,0.000289034689578393
"4404","2020/08/27","BD",163046173,2519,54,17056,301,302147,4082,30266,47034,0.00185313763850195,1.54496113196107e-05,0.000185628398649995,0.000288470432237621
"4403","2020/08/28","BD",163046173,2436,45,16624,305,304583,4127,30058,46983,0.00186807819156847,1.49405530665231e-05,0.000184352686401293,0.000288157637407411
"4402","2020/08/29","BD",163046173,2211,47,16434,313,306794,4174,30245,46287,0.00188163876744289,1.35605758744181e-05,0.000185499600778732,0.000283888907959833
"4401","2020/08/30","BD",163046173,2131,32,16300,299,308925,4206,29781,45422,0.00189470868476011,1.30699173172252e-05,0.000182653781147013,0.000278583662310185
"4400","2020/08/31","BD",163046173,1897,42,16224,307,310822,4248,28478,44324,0.00190634342579755,1.16347410374361e-05,0.000174662179896734,0.000271849373612713
"4399","2020/09/01","BD",163046173,2174,33,15913,298,312996,4281,27905,43881,0.00191967707208927,1.33336462917164e-05,0.00017114783798084,0.000269132351852257
"4398","2020/09/02","BD",163046173,1950,35,15318,288,314946,4316,26987,43065,0.00193163687442084,1.19598023315763e-05,0.000165517531037052,0.00026412763456889
"4397","2020/09/03","BD",163046173,2582,35,15381,269,317528,4351,27168,43003,0.00194747287935424,1.58360049334001e-05,0.000166627646022701,0.000263747374187065
"4396","2020/09/04","BD",163046173,2158,32,15103,256,319686,4383,27061,43137,0.00196070839393452,1.32355145802778e-05,0.000165971390202455,0.000264569227270363
"4395","2020/09/05","BD",163046173,1929,29,14821,238,321615,4412,27017,42471,0.00197253939839483,1.18310044603132e-05,0.000165701527995999,0.000260484494781733
"4394","2020/09/06","BD",163046173,1950,35,14640,241,323565,4447,26482,41221,0.00198449920072641,1.19598023315763e-05,0.000162420248894772,0.000252817954825594
"4393","2020/09/07","BD",163046173,1592,2,14335,201,325157,4449,25529,40066,0.00199426330601455,9.76410528813823e-06,0.000156575278832212,0.000245734071906122
"4392","2020/09/08","BD",163046173,2202,67,14363,235,327359,4516,25212,39400,0.00200776868280128,1.35053767867339e-05,0.000154631044299335,0.000241649339417491
"4391","2020/09/09","BD",163046173,1892,36,14305,236,329251,4552,24668,38891,0.00201937275767889,1.16040748776115e-05,0.000151294566110423,0.000238527524347352
"4390","2020/09/10","BD",163046173,1827,41,13550,242,331078,4593,24284,38453,0.00203057817247879,1.12054147998923e-05,0.000148939405035897,0.000235841168746721
"4389","2020/09/11","BD",163046173,1892,41,13284,251,332970,4634,24045,38372,0.0020421822473564,1.16040748776115e-05,0.000147473562596284,0.000235344376957563
"4388","2020/09/12","BD",163046173,1792,34,13147,256,334762,4668,23940,37679,0.00205317299903752,1.09907516811204e-05,0.000146829573239968,0.00023109404720588
"4387","2020/09/13","BD",163046173,1282,34,12479,255,336044,4702,23048,36416,0.00206103580241653,7.86280337901583e-06,0.000141358730327267,0.000223347775234197
"4386","2020/09/14","BD",163046173,1476,31,12363,284,337520,4733,22574,35373,0.00207008845279674,9.05265038020856e-06,0.0001384515783759,0.000216950814294795
"4385","2020/09/15","BD",163046173,1812,26,11973,243,339332,4759,21804,34749,0.00208120186911716,1.11134163204186e-05,0.000133728989762918,0.00021312367754869
"4384","2020/09/16","BD",163046173,1724,43,11805,250,341056,4802,21370,34262,0.00209177556102467,1.05736919075065e-05,0.000131067167090147,0.000210136793581779
"4383","2020/09/17","BD",163046173,1615,21,11593,230,342671,4823,21056,33746,0.002101680730648,9.90516962333118e-06,0.000129141332253165,0.000206972045887885
"4382","2020/09/18","BD",163046173,1593,36,11294,225,344264,4859,20699,33442,0.0021114509691681,9.77023852010314e-06,0.000126951768441692,0.000205107543370552
"4381","2020/09/19","BD",163046173,1541,22,11043,213,345805,4881,20648,32809,0.00212090227962603,9.45131045792777e-06,0.000126638973611481,0.000201225207536763
"4380","2020/09/20","BD",163046173,1567,32,11328,211,347372,4913,20013,32426,0.00213051305411505,9.61077448901545e-06,0.000122744371313763,0.000198876179694202
"4379","2020/09/21","BD",163046173,1544,26,11396,206,348916,4939,19665,31388,0.00213998276426887,9.4697101538225e-06,0.000120610006589974,0.000192509884914625
"4378","2020/09/22","BD",163046173,1705,40,11289,220,350621,4979,19543,30935,0.00215043992476904,1.04571605001732e-05,0.000119861752290255,0.00018973153083452
"4377","2020/09/23","BD",163046173,1557,28,11122,205,352178,5007,19208,30563,0.00215998936693841,9.54944216936634e-06,0.000117807119582009,0.000187449968543573
"4376","2020/09/24","BD",163046173,1666,37,11173,221,353844,5044,19082,30279,0.00217020733139195,1.02179644535416e-05,0.000117034332354431,0.000185708130665539
"4375","2020/09/25","BD",163046173,1540,28,11120,213,355384,5072,19340,30227,0.00217965250861791,9.44517722596286e-06,0.000118616706201378,0.000185389202603363
"4374","2020/09/26","BD",163046173,1383,21,10962,212,356767,5093,19247,29408,0.00218813476842538,8.48225980747184e-06,0.000118046315628641,0.000180366085624101
"4373","2020/09/27","BD",163046173,1106,36,10501,216,357873,5129,18541,28622,0.00219491812297857,6.78335455319151e-06,0.000113716253861414,0.000175545365299681
"4372","2020/09/28","BD",163046173,1275,32,10232,222,359148,5161,18092,28070,0.00220273799373384,7.81987075526146e-06,0.000110962432709169,0.00017215982125505
"4371","2020/09/29","BD",163046173,1407,32,9934,214,360555,5193,17884,27585,0.00221136745110847,8.6294573746297e-06,0.000109686720460467,0.000169185203752068
"4370","2020/09/30","BD",163046173,1488,26,9865,212,362043,5219,17779,27281,0.00222049370027225,9.12624916378749e-06,0.000109042731104152,0.000167320701234736
"4369","2020/10/01","BD",163046173,1436,32,9635,207,363479,5251,17674,27435,0.00222930102137387,8.80732110161212e-06,0.000108398741747836,0.000168265218957332
"4368","2020/10/02","BD",163046173,1508,21,9603,200,364987,5272,17615,27467,0.00223854993517695,9.24891380308571e-06,0.000108036881061906,0.000168461482380209
"4367","2020/10/03","BD",163046173,1396,33,9616,212,366383,5305,17467,27051,0.00224711192699997,8.56199182301568e-06,0.000107129162731099,0.000165910057882806
"4366","2020/10/04","BD",163046173,1182,20,9692,196,367565,5325,16944,26509,0.00225436140718249,7.24948018252474e-06,0.000103921482413451,0.000162585846157824
"4365","2020/10/05","BD",163046173,1125,23,9542,187,368690,5348,16512,26019,0.00226126129314302,6.89988596052481e-06,0.00010127192620461,0.000159580562495018
"4364","2020/10/06","BD",163046173,1442,27,9577,182,370132,5375,16288,25868,0.00227010541363642,8.84412049340158e-06,9.98980822444695e-05,0.000158654444468316
"4363","2020/10/07","BD",163046173,1499,30,9588,186,371631,5405,16247,25826,0.00227929912835182,9.19371471540151e-06,9.96466197339081e-05,0.00015839684872579
"4362","2020/10/08","BD",163046173,1520,35,9672,189,373151,5440,16384,25779,0.00228862164093848,9.32251258666464e-06,0.000100486872513101,0.000158108586823439
"4361","2020/10/09","BD",163046173,1441,20,9605,188,374592,5460,16719,25676,0.00229745962819992,8.83798726143667e-06,0.000102541505221346,0.000157476863931053
"4360","2020/10/10","BD",163046173,1278,17,9487,172,375870,5477,16722,25249,0.00230529789865108,7.83827045115619e-06,0.000102559904917241,0.000154857973882036
"4359","2020/10/11","BD",163046173,1203,23,9508,175,377073,5500,16518,24895,0.00231267617670487,7.37827805378787e-06,0.000101308725596399,0.000152686809766458
"4358","2020/10/12","BD",163046173,1193,24,9576,176,378266,5524,16223,24422,0.002319993122439,7.31694573413876e-06,9.94994221667503e-05,0.000149785791047055
"4357","2020/10/13","BD",163046173,1472,31,9606,180,379738,5555,16259,24354,0.00232902123989135,9.02811745234891e-06,9.97202185174871e-05,0.000149368731273441
"4356","2020/10/14","BD",163046173,1537,22,9644,172,381275,5577,16288,24508,0.00233844801742142,9.42677753006812e-06,9.98980822444695e-05,0.000150313248996037
"4355","2020/10/15","BD",163046173,1684,16,9808,153,382959,5593,16576,25086,0.00234877638005033,1.032836262891e-05,0.000101664453050364,0.000153858257071756
"4354","2020/10/16","BD",163046173,1600,15,9967,148,384559,5608,16994,25411,0.00235858955119419,9.81317114385751e-06,0.000104228144011697,0.000155851557460352
"4353","2020/10/17","BD",163046173,1527,15,10216,146,386086,5623,17396,25531,0.00236795499640461,9.36544521041901e-06,0.000106693703261591,0.000156587545296141
"4352","2020/10/18","BD",163046173,1209,23,10222,146,387295,5646,17163,25252,0.00237537007385018,7.41507744557733e-06,0.000105264660213767,0.000154876373577931
"4351","2020/10/19","BD",163046173,1274,14,10303,136,388569,5660,16938,25090,0.00238318381137348,7.81373752329655e-06,0.000103884683021662,0.000153882789999616
"4350","2020/10/20","BD",163046173,1637,21,10468,126,390206,5681,17055,25219,0.00239322391210004,1.00401007265592e-05,0.000104602271161556,0.000154673976923089
"4349","2020/10/21","BD",163046173,1383,18,10314,122,391589,5699,16997,25206,0.00240170617190751,8.48225980747184e-06,0.000104246543707591,0.000154594244907545
"4348","2020/10/22","BD",163046173,1542,24,10172,130,393131,5723,17261,25566,0.00241116361559741,9.45744368989268e-06,0.000105865716946328,0.000156802208414913
"4347","2020/10/23","BD",163046173,1696,24,10268,139,394827,5747,17754,26137,0.00242156557700989,1.0401961412489e-05,0.000108889400305029,0.000160304283866877
"4346","2020/10/24","BD",163046173,1586,14,10327,138,396413,5761,18147,26281,0.00243129288290624,9.72730589634876e-06,0.000111299760467239,0.000161187469269825
"4345","2020/10/25","BD",163046173,1094,19,10212,134,397507,5780,17769,25876,0.00243800263867586,6.70975576961257e-06,0.000108981398784503,0.000158703510324036
"4344","2020/10/26","BD",163046173,1308,23,10246,143,398815,5803,17540,25664,0.00244602490608596,8.02226741010352e-06,0.000107576888664538,0.000157403265147475
"4343","2020/10/27","BD",163046173,1436,15,10045,137,400251,5818,17292,25659,0.00245483222718757,8.80732110161212e-06,0.00010605584713724,0.00015737259898765
"4342","2020/10/28","BD",163046173,1335,20,9997,139,401586,5838,17027,25716,0.00246302009186073,8.18786467315611e-06,0.000104430540666539,0.00015772219320965
"4341","2020/10/29","BD",163046173,1493,23,9948,138,403079,5861,16993,26006,0.00247217700718434,9.15691532361204e-06,0.000104222010779732,0.000159500830479474
"4340","2020/10/30","BD",163046173,1681,25,9933,139,404760,5886,17465,26494,0.00248248697011735,1.03099629330153e-05,0.00010711689626717,0.000162493847678351
"4339","2020/10/31","BD",163046173,1604,19,9951,144,406364,5905,17795,26626,0.00249232467418907,9.83770407171716e-06,0.00010914086281559,0.000163303434297719
"4338","2020/11/01","BD",163046173,1320,18,10177,143,407684,5923,17478,26409,0.00250042054038275,8.09586619368245e-06,0.000107196628282714,0.000161972522961333
"4337","2020/11/02","BD",163046173,1568,18,10437,138,409252,5941,17663,26293,0.00251003744810373,9.61690772098036e-06,0.000108331276196222,0.000161261068053403
"4336","2020/11/03","BD",163046173,1736,25,10737,148,410988,5966,17857,26429,0.00252068473879482,1.06472906910854e-05,0.000109521123197415,0.000162095187600631
"4335","2020/11/04","BD",163046173,1659,17,11061,145,412647,5983,17820,26561,0.00253085977062461,1.01750318297873e-05,0.000109294193614713,0.00016290477422
"4334","2020/11/05","BD",163046173,1517,21,11085,143,414164,6004,17751,26869,0.00254016388351538,9.3041128907699e-06,0.000108871000609134,0.000164793809665192
"4333","2020/11/06","BD",163046173,1842,17,11246,135,416006,6021,18499,27437,0.00255146129679474,1.1297413279366e-05,0.000113458658118888,0.000168277485421262
"4332","2020/11/07","BD",163046173,1469,15,11111,131,417475,6036,18660,27269,0.0025604710145512,9.00971775645418e-06,0.000114446108465238,0.000167247102451157
"4331","2020/11/08","BD",163046173,1289,13,11080,126,418764,6049,18513,27175,0.00256837675055397,7.90573600277021e-06,0.000113544523366396,0.000166670578646455
"4330","2020/11/09","BD",163046173,1474,18,10986,126,420238,6067,18652,27107,0.00257741713447025,9.04038391627873e-06,0.000114397042609519,0.000166253518872841
"4329","2020/11/10","BD",163046173,1683,25,10933,126,421921,6092,18842,27094,0.00258773936386719,1.03222293969451e-05,0.000115562356682852,0.000166173786857297
"4328","2020/11/11","BD",163046173,1699,16,10973,125,423620,6108,18860,27207,0.00259815972497557,1.04203611083837e-05,0.00011567275485822,0.000166866842069332
"4327","2020/11/12","BD",163046173,1733,19,11189,123,425353,6127,18989,27846,0.00260878861597077,1.06288909951907e-05,0.000116463941781694,0.00017078597729491
"4326","2020/11/13","BD",163046173,1845,13,11192,119,427198,6140,19514,28383,0.00262010442894603,1.13158129752607e-05,0.000119683888563272,0.000174079522860067
"4325","2020/11/14","BD",163046173,1767,19,11490,123,428965,6159,19713,28714,0.00263094184982802,1.08374208819976e-05,0.000120904401724289,0.000176109622640453
"4324","2020/11/15","BD",163046173,1531,14,11732,124,430496,6173,19508,28910,0.0026403318279663,9.38997813827866e-06,0.000119647089171483,0.000177311736105575
"4323","2020/11/16","BD",163046173,1837,21,12095,127,432333,6194,19686,29254,0.00265159857508584,1.12667471195414e-05,0.000120738804461237,0.000179421567901505
"4322","2020/11/17","BD",163046173,2139,21,12551,123,434472,6215,20308,29712,0.00266471755825879,1.31189831729445e-05,0.000124553674743411,0.000182230588141434
"4321","2020/11/18","BD",163046173,2212,39,13064,146,436684,6254,20678,30320,0.00267828426736517,1.3566709106383e-05,0.000126822970570429,0.0001859595931761
"4320","2020/11/19","BD",163046173,2111,21,13442,148,438795,6275,21320,31111,0.0026912315200431,1.2947252677927e-05,0.000130760505491901,0.000190810979660344
"4319","2020/11/20","BD",163046173,2364,30,13961,165,441159,6305,22395,31907,0.00270573048040815,1.44989603650495e-05,0.000137353729854181,0.000195693032304414
"4318","2020/11/21","BD",163046173,2275,17,14469,163,443434,6322,23196,32446,0.00271968358312832,1.39531027201724e-05,0.000142266448658074,0.000198998844333501
"4317","2020/11/22","BD",163046173,1847,28,14785,177,445281,6350,23360,32634,0.00273101166256751,1.13280794391905e-05,0.00014327229870032,0.000200151891942904
"4316","2020/11/23","BD",163046173,2060,38,15008,194,447341,6388,23721,33177,0.00274364612041523,1.26344578477165e-05,0.000145486395439653,0.00020348223689985
"4315","2020/11/24","BD",163046173,2419,28,15288,201,449760,6416,24407,33754,0.00275848240853835,1.48362881231196e-05,0.000149693792567581,0.000207021111743604
"4314","2020/11/25","BD",163046173,2230,32,15306,194,451990,6448,24792,34515,0.0027721595158201,1.36771072817514e-05,0.000152055086874072,0.000211688501268901
