"","date","countrycode","population","cases","deaths","cases_prev_week","deaths_prev_week","cases_infected","cum_deaths","cases_contagious","cases_active","p_cases_infected","p_cases","p_cases_contagious","p_cases_active"
"35450","2020/03/03","MA",36471766,1,0,1,0,1,0,1,1,2.74184693990414e-08,2.74184693990414e-08,2.74184693990414e-08,2.74184693990414e-08
"35449","2020/03/06","MA",36471766,1,0,2,0,2,0,2,2,5.48369387980829e-08,2.74184693990414e-08,5.48369387980829e-08,5.48369387980829e-08
"35448","2020/03/12","MA",36471766,3,1,5,1,5,1,5,5,1.37092346995207e-07,8.22554081971243e-08,1.37092346995207e-07,1.37092346995207e-07
"35447","2020/03/13","MA",36471766,1,0,6,1,6,1,6,6,1.64510816394249e-07,2.74184693990414e-08,1.64510816394249e-07,1.64510816394249e-07
"35446","2020/03/14","MA",36471766,1,0,7,1,7,1,7,7,1.9192928579329e-07,2.74184693990414e-08,1.9192928579329e-07,1.9192928579329e-07
"35445","2020/03/15","MA",36471766,11,0,18,1,18,1,18,18,4.93532449182746e-07,3.01603163389456e-07,4.93532449182746e-07,4.93532449182746e-07
"35444","2020/03/16","MA",36471766,10,0,28,1,28,1,28,28,7.6771714317316e-07,2.74184693990414e-07,7.6771714317316e-07,7.6771714317316e-07
"35443","2020/03/17","MA",36471766,9,0,36,1,37,1,37,37,1.01448336776453e-06,2.46766224591373e-07,1.01448336776453e-06,1.01448336776453e-06
"35442","2020/03/18","MA",36471766,7,1,42,2,44,2,44,44,1.20641265355782e-06,1.9192928579329e-07,1.20641265355782e-06,1.20641265355782e-06
"35441","2020/03/19","MA",36471766,10,0,49,1,54,2,54,54,1.48059734754824e-06,2.74184693990414e-07,1.48059734754824e-06,1.48059734754824e-06
"35440","2020/03/20","MA",36471766,9,0,57,1,63,2,63,63,1.72736357213961e-06,2.46766224591373e-07,1.72736357213961e-06,1.72736357213961e-06
"35439","2020/03/21","MA",36471766,23,1,79,2,86,3,86,86,2.35798836831756e-06,6.30624796177953e-07,2.35798836831756e-06,2.35798836831756e-06
"35438","2020/03/22","MA",36471766,10,0,78,2,96,3,95,96,2.63217306230798e-06,2.74184693990414e-07,2.60475459290894e-06,2.63217306230798e-06
"35437","2020/03/23","MA",36471766,19,1,87,3,115,4,113,115,3.15312398088977e-06,5.20950918581787e-07,3.09828704209168e-06,3.15312398088977e-06
"35436","2020/03/24","MA",36471766,19,0,97,3,134,4,129,134,3.67407489947155e-06,5.20950918581787e-07,3.53698255247635e-06,3.67407489947155e-06
"35435","2020/03/25","MA",36471766,36,1,126,3,170,5,164,170,4.66113979783704e-06,9.87064898365492e-07,4.4966289814428e-06,4.66113979783704e-06
"35434","2020/03/26","MA",36471766,55,1,171,4,225,6,218,225,6.16915561478432e-06,1.50801581694728e-06,5.97722632899103e-06,6.16915561478432e-06
"35433","2020/03/27","MA",36471766,50,4,212,8,275,10,257,275,7.5400790847364e-06,1.37092346995207e-06,7.04654663555365e-06,7.5400790847364e-06
"35432","2020/03/28","MA",36471766,70,13,259,20,345,23,317,344,9.4593719426693e-06,1.9192928579329e-06,8.69165479949614e-06,9.43195347327026e-06
"35431","2020/03/29","MA",36471766,13,0,262,20,358,23,321,356,9.81581204485683e-06,3.56440102187539e-07,8.8013286770923e-06,9.76097510605875e-06
"35430","2020/03/30","MA",36471766,121,3,364,22,479,26,435,474,1.31334468421408e-05,3.31763479728401e-06,1.1927034188583e-05,1.29963544951456e-05
"35429","2020/03/31","MA",36471766,77,7,422,29,556,33,502,550,1.5244668985867e-05,2.11122214372619e-06,1.37640716383188e-05,1.50801581694728e-05
"35428","2020/04/01","MA",36471766,61,3,447,31,617,36,554,610,1.69171956192086e-05,1.67252663334153e-06,1.5189832047069e-05,1.67252663334153e-05
"35427","2020/04/02","MA",36471766,37,3,429,33,654,39,568,636,1.79316789869731e-05,1.01448336776453e-06,1.55736906186555e-05,1.74381465377904e-05
"35426","2020/04/03","MA",36471766,54,5,433,34,708,44,612,680,1.94122763345213e-05,1.48059734754824e-06,1.67801032722134e-05,1.86445591913482e-05
"35425","2020/04/04","MA",36471766,0,0,363,21,708,44,593,671,1.94122763345213e-05,0,1.62591523536316e-05,1.83977929667568e-05
"35424","2020/04/05","MA",36471766,211,15,561,36,919,59,785,875,2.51975733777191e-05,5.78529704319774e-06,2.15234984782475e-05,2.39911607241613e-05
"35423","2020/04/06","MA",36471766,102,11,542,44,1021,70,851,967,2.79942572564213e-05,2.79668387870223e-06,2.33331174585843e-05,2.65136599088731e-05
"35422","2020/04/07","MA",36471766,99,10,564,47,1120,80,895,1057,3.07086857269264e-05,2.7144284705051e-06,2.45395301121421e-05,2.89813221547868e-05
"35421","2020/04/08","MA",36471766,64,10,567,54,1184,90,909,1098,3.24634677684651e-05,1.75478204153865e-06,2.49233886837287e-05,3.01054794001475e-05
"35420","2020/04/09","MA",36471766,91,3,621,54,1275,93,930,1179,3.49585484837778e-05,2.49508071531277e-06,2.54991765411085e-05,3.23263754214699e-05
"35419","2020/04/10","MA",36471766,99,4,666,53,1374,97,1016,1259,3.76729769542829e-05,2.7144284705051e-06,2.78571649094261e-05,3.45198529733932e-05
"35418","2020/04/11","MA",36471766,74,10,740,63,1448,107,969,1314,3.9701943689812e-05,2.02896673552907e-06,2.65684968476712e-05,3.60278687903404e-05
"35417","2020/04/12","MA",36471766,97,4,626,52,1545,111,989,1375,4.2361535221519e-05,2.65959153170702e-06,2.7116866235652e-05,3.7700395423682e-05
"35416","2020/04/13","MA",36471766,116,7,640,48,1661,118,1044,1436,4.55420776718078e-05,3.18054245028881e-06,2.86248820525993e-05,3.93729220570235e-05
"35415","2020/04/14","MA",36471766,102,8,643,46,1763,126,1109,1488,4.83387615505101e-05,2.79668387870223e-06,3.0407082563537e-05,4.07986824657737e-05
"35414","2020/04/15","MA",36471766,125,0,704,36,1888,126,1180,1543,5.17660702253902e-05,3.42730867488018e-06,3.23537938908689e-05,4.23066982827209e-05
"35413","2020/04/16","MA",36471766,136,1,749,34,2024,127,1316,1666,5.54949820636599e-05,3.72891183826964e-06,3.60827057291385e-05,4.5679170018803e-05
"35412","2020/04/17","MA",36471766,259,3,909,33,2283,130,1364,1804,6.25963656380116e-05,7.10138357435173e-06,3.73987922602925e-05,4.94629187958708e-05
"35411","2020/04/18","MA",36471766,281,5,1116,28,2564,135,1543,2008,7.03009555391423e-05,7.70458990113065e-06,4.23066982827209e-05,5.50562865532752e-05
"35410","2020/04/19","MA",36471766,121,2,1140,26,2685,137,1565,2068,7.36185903364263e-05,3.31763479728401e-06,4.29099046094999e-05,5.67013947172177e-05
"35409","2020/04/20","MA",36471766,170,4,1194,23,2855,141,1671,2201,7.82797301342633e-05,4.66113979783704e-06,4.58162623657982e-05,6.03480511472902e-05
"35408","2020/04/21","MA",36471766,191,2,1283,17,3046,143,1771,2338,8.35166577894802e-05,5.23692765521691e-06,4.85581093057024e-05,6.41043814549589e-05
"35407","2020/04/22","MA",36471766,163,2,1321,19,3209,145,1835,2501,8.7985868301524e-05,4.46921051204375e-06,5.0312891347241e-05,6.85735919670026e-05
"35406","2020/04/23","MA",36471766,168,4,1353,22,3377,149,1929,2458,9.25921711605629e-05,4.60630285903896e-06,5.28902274707509e-05,6.73945977828439e-05
"35405","2020/04/24","MA",36471766,191,6,1285,25,3568,155,2023,2547,9.78290988157799e-05,5.23692765521691e-06,5.54675635942608e-05,6.98348415593585e-05
"35404","2020/04/25","MA",36471766,190,3,1194,23,3758,158,2097,2638,0.000103038608001598,5.20950918581787e-06,5.74965303297899e-05,7.23299222746713e-05
"35403","2020/04/26","MA",36471766,139,1,1212,22,3897,159,2134,2713,0.000106849775248064,3.81116724646676e-06,5.85110136975544e-05,7.43863074795994e-05
"35402","2020/04/27","MA",36471766,168,2,1210,20,4065,161,2177,2790,0.000111456078107103,4.60630285903896e-06,5.96900078817132e-05,7.64975296233256e-05
"35401","2020/04/28","MA",36471766,55,1,1074,19,4120,162,2096,2746,0.000112964093924051,1.50801581694728e-06,5.74691118603909e-05,7.52911169697678e-05
"35400","2020/04/29","MA",36471766,132,3,1043,20,4252,165,1969,2804,0.000116583331884724,3.61923796067347e-06,5.39869662467126e-05,7.68813881949122e-05
"35399","2020/04/30","MA",36471766,69,3,944,19,4321,168,1757,2776,0.000118475206273258,1.89187438853386e-06,4.81742507341158e-05,7.6113671051739e-05
"35398","2020/05/01","MA",36471766,102,2,855,15,4423,170,1738,2762,0.00012127189015196,2.79668387870223e-06,4.7653299815534e-05,7.57298124801525e-05
"35397","2020/05/02","MA",36471766,146,1,811,13,4569,171,1714,2806,0.00012527498668422,4.00309653226005e-06,4.6995256549957e-05,7.69362251337103e-05
"35396","2020/05/03","MA",36471766,160,2,832,14,4729,173,1683,2841,0.000129661941788067,4.38695510384663e-06,4.61452839985867e-05,7.78958715626767e-05
"35395","2020/05/04","MA",36471766,174,1,838,13,4903,174,1694,2879,0.0001344327554635,4.77081367543321e-06,4.64468871619762e-05,7.89377733998403e-05
"35394","2020/05/05","MA",36471766,140,5,923,17,5043,179,1666,2760,0.000138271341179366,3.8385857158658e-06,4.5679170018803e-05,7.56749755413544e-05
"35393","2020/05/06","MA",36471766,176,2,967,16,5219,181,1651,2655,0.000143096991793597,4.82565061423129e-06,4.52678929778174e-05,7.2796036254455e-05
"35392","2020/05/07","MA",36471766,189,2,1087,15,5408,183,1650,2723,0.000148279082510016,5.18209071641883e-06,4.52404745084184e-05,7.46604921735898e-05
"35391","2020/05/08","MA",36471766,140,0,1125,13,5548,183,1651,2693,0.000152117668225882,3.8385857158658e-06,4.52678929778174e-05,7.38379380916186e-05
"35390","2020/05/09","MA",36471766,163,3,1142,15,5711,186,1646,2665,0.000156586878737926,4.46921051204375e-06,4.51308006308222e-05,7.30702209484454e-05
"35389","2020/05/10","MA",36471766,199,0,1181,13,5910,186,1790,2701,0.000162043154148335,5.45627541040925e-06,4.90790602242842e-05,7.40572858468109e-05
"35388","2020/05/11","MA",36471766,153,2,1160,14,6063,188,1811,2686,0.000166238179966388,4.19502581805334e-06,4.9654848081664e-05,7.36460088058253e-05
"35387","2020/05/12","MA",36471766,218,0,1238,9,6281,188,1960,2713,0.000172215406295379,5.97722632899103e-06,5.37402000221212e-05,7.43863074795994e-05
"35386","2020/05/13","MA",36471766,137,0,1199,7,6418,188,1995,2660,0.000175971736603048,3.75633030766868e-06,5.46998464510877e-05,7.29331286014502e-05
"35385","2020/05/14","MA",36471766,94,0,1104,5,6512,188,1943,2615,0.000178549072726558,2.5773361235099e-06,5.32740860423375e-05,7.16992974784934e-05
"35384","2020/05/15","MA",36471766,95,2,1059,7,6607,190,1878,2542,0.000181153827319467,2.60475459290894e-06,5.14918855313998e-05,6.96977492123633e-05
"35383","2020/05/16","MA",36471766,45,0,941,4,6652,190,1749,2532,0.000182387658442424,1.23383112295686e-06,4.79549029789235e-05,6.94235645183729e-05
"35382","2020/05/17","MA",36471766,89,2,831,6,6741,192,1698,2489,0.000184827902218938,2.44024377651469e-06,4.65565610395724e-05,6.82445703342141e-05
"35381","2020/05/18","MA",36471766,129,0,807,4,6870,192,1651,2549,0.000188364884771415,3.53698255247635e-06,4.52678929778174e-05,6.98896784981566e-05
"35380","2020/05/19","MA",36471766,82,0,671,4,6952,192,1544,2529,0.000190613199262136,2.2483144907214e-06,4.233411675212e-05,6.93413091101758e-05
"35379","2020/05/20","MA",36471766,71,1,605,5,7023,193,1475,2454,0.000192559910589468,1.94671132733194e-06,4.04422423635861e-05,6.72849239052477e-05
"35378","2020/05/21","MA",36471766,110,1,621,6,7133,194,1422,2404,0.000195575942223363,3.01603163389456e-06,3.89890634854369e-05,6.59140004352956e-05
"35377","2020/05/22","MA",36471766,78,2,604,6,7211,196,1301,2308,0.000197714582836488,2.13864061312523e-06,3.56714286881529e-05,6.32818273729876e-05
"35376","2020/05/23","MA",36471766,121,1,680,7,7332,197,1269,2289,0.000201032217633772,3.31763479728401e-06,3.47940376673836e-05,6.27608764544059e-05
"35375","2020/05/24","MA",36471766,74,1,665,6,7406,198,1125,2187,0.000203061184369301,2.02896673552907e-06,3.08457780739216e-05,5.99641925757036e-05
"35374","2020/05/25","MA",36471766,27,1,563,7,7433,199,1015,2025,0.000203801483043075,7.40298673774119e-07,2.78297464400271e-05,5.55224005330589e-05
"35373","2020/05/26","MA",36471766,99,1,580,8,7532,200,1020,1984,0.00020651591151358,2.7144284705051e-06,2.79668387870223e-05,5.43982432876982e-05
"35372","2020/05/27","MA",36471766,45,2,554,9,7577,202,970,1866,0.000207749742636537,1.23383112295686e-06,2.65959153170702e-05,5.11628638986113e-05
"35371","2020/05/28","MA",36471766,24,0,468,8,7601,202,949,1691,0.000208407785902114,6.58043265576995e-07,2.60201274596903e-05,4.63646317537791e-05
"35370","2020/05/29","MA",36471766,42,0,432,6,7643,202,902,1580,0.000209559361616874,1.15157571475974e-06,2.47314593979354e-05,4.33211816504855e-05
"35369","2020/05/30","MA",36471766,71,0,382,5,7714,202,844,1433,0.000211506072944206,1.94671132733194e-06,2.3141188172791e-05,3.92906666488264e-05
"35368","2020/05/31","MA",36471766,66,2,374,6,7780,204,828,1362,0.000213315691924542,1.80961898033674e-06,2.27024926624063e-05,3.73439553214944e-05
"35367","2020/06/01","MA",36471766,27,1,374,6,7807,205,784,1295,0.000214055990598317,7.40298673774119e-07,2.14960800088485e-05,3.55069178717587e-05
"35366","2020/06/02","MA",36471766,26,0,301,5,7833,205,700,1226,0.000214768870802692,7.12880204375077e-07,1.9192928579329e-05,3.36150434832248e-05
"35365","2020/06/03","MA",36471766,33,1,289,4,7866,206,655,1214,0.00021567368029286,9.04809490168368e-07,1.79590974563721e-05,3.32860218504363e-05
"35364","2020/06/04","MA",36471766,56,0,321,4,7922,206,590,1181,0.000217209114579206,1.53543428634632e-06,1.61768969454344e-05,3.23812123602679e-05
"35363","2020/06/05","MA",36471766,81,2,360,6,8003,208,597,1133,0.000219430010600529,2.22089602132236e-06,1.63688262312277e-05,3.10651258291139e-05
"35362","2020/06/06","MA",36471766,68,0,357,6,8071,208,638,1119,0.000221294466519663,1.86445591913482e-06,1.74929834765884e-05,3.06812672575274e-05
"35361","2020/06/07","MA",36471766,61,0,352,4,8132,208,600,1109,0.000222966993153005,1.67252663334153e-06,1.64510816394249e-05,3.0407082563537e-05
"35360","2020/06/08","MA",36471766,92,0,417,3,8224,208,647,1091,0.000225489492337717,2.52249918471181e-06,1.77397497011798e-05,2.99135501143542e-05
"35359","2020/06/09","MA",36471766,78,0,469,3,8302,208,701,1091,0.000227628132950842,2.13864061312523e-06,1.9220347048728e-05,2.99135501143542e-05
"35358","2020/06/10","MA",36471766,135,2,571,4,8437,210,794,1105,0.000231329626319713,3.70149336887059e-06,2.17702647028389e-05,3.02974086859408e-05
"35357","2020/06/11","MA",36471766,18,0,533,4,8455,210,741,1049,0.000231823158768895,4.93532449182746e-07,2.03170858246897e-05,2.87619743995945e-05
"35356","2020/06/12","MA",36471766,82,1,534,3,8537,211,757,1104,0.000234071473259617,2.2483144907214e-06,2.07557813350744e-05,3.02699902165417e-05
"35355","2020/06/13","MA",36471766,73,1,539,4,8610,212,803,1078,0.000236073021525747,2.00154826613003e-06,2.20170309274303e-05,2.95571100121667e-05
"35354","2020/06/14","MA",36471766,82,0,560,4,8692,212,859,1115,0.000238321336016468,2.2483144907214e-06,2.35524652137766e-05,3.05715933799312e-05
"35353","2020/06/15","MA",36471766,42,0,510,4,8734,212,868,1133,0.000239472911731228,1.15157571475974e-06,2.3799231438368e-05,3.10651258291139e-05
"35352","2020/06/16","MA",36471766,104,0,536,4,8838,212,916,1195,0.000242324432548728,2.85152081750031e-06,2.5115317969522e-05,3.27650709318545e-05
"35351","2020/06/17","MA",36471766,83,0,484,2,8921,212,918,1207,0.000244600165508849,2.27573296012044e-06,2.517015490832e-05,3.3094092564643e-05
"35350","2020/06/18","MA",36471766,76,1,542,3,8997,213,926,1217,0.000246683969183176,2.08380367432715e-06,2.53895026635124e-05,3.33682772586334e-05
"35349","2020/06/19","MA",36471766,77,0,537,2,9074,213,942,1267,0.000248795191326902,2.11122214372619e-06,2.5828198173897e-05,3.47392007285855e-05
"35348","2020/06/20","MA",36471766,539,0,1003,1,9613,213,1389,1780,0.000263573746332985,1.47785550060833e-05,3.80842539952686e-05,4.88048755302938e-05
"35347","2020/06/21","MA",36471766,188,0,1109,1,9801,213,1499,1935,0.000268728418580005,5.15467224701979e-06,4.11002856291631e-05,5.30547382871452e-05
"35346","2020/06/22","MA",36471766,176,1,1243,2,9977,214,1540,2055,0.000273554069194236,4.82565061423129e-06,4.22244428745238e-05,5.63449546150302e-05
"35345","2020/06/23","MA",36471766,195,0,1334,2,10172,214,1717,2169,0.00027890067072705,5.34660153281308e-06,4.70775119581542e-05,5.94706601265209e-05
"35344","2020/06/24","MA",36471766,92,0,1343,2,10264,214,1727,2193,0.000281423169911761,2.52249918471181e-06,4.73516966521446e-05,6.01287033920979e-05
"35343","2020/06/25","MA",36471766,643,2,1910,3,10907,216,2297,2775,0.000299053245735345,1.76300758235836e-05,6.29802242095982e-05,7.608625258234e-05
"35342","2020/06/26","MA",36471766,431,1,2264,4,11338,217,2646,3114,0.000310870606046332,1.18173603109869e-05,7.25492700298636e-05,8.5381113708615e-05
"35341","2020/06/27","MA",36471766,295,1,2020,5,11633,218,2899,3331,0.000318959054519049,8.08844847271722e-06,7.94861427878211e-05,9.1330921568207e-05
"35340","2020/06/28","MA",36471766,244,2,2076,7,11877,220,3039,3440,0.000325649161052415,6.69010653336611e-06,8.33247285036869e-05,9.43195347327026e-05
"35339","2020/06/29","MA",36471766,175,1,2075,7,12052,221,3131,3597,0.000330447393197247,4.79823214483225e-06,8.58472276883987e-05,9.86242344283521e-05
"35338","2020/06/30","MA",36471766,238,4,2118,11,12290,225,3293,3753,0.000336972988914219,6.52559571697186e-06,9.02890197310435e-05,0.000102901515654603
"35337","2020/07/01","MA",36471766,243,3,2269,14,12533,228,3459,3923,0.000343635676978186,6.66268806396707e-06,9.48404856512843e-05,0.00010756265545244
"35336","2020/07/02","MA",36471766,103,0,1729,12,12636,228,3023,3944,0.000346459779326288,2.82410234810127e-06,8.28860329933023e-05,0.000108138443309819
"35335","2020/07/03","MA",36471766,333,1,1631,12,12969,229,3168,4235,0.000355590129636168,9.1303503098808e-06,8.68617110561633e-05,0.00011611721790494
"35334","2020/07/04","MA",36471766,319,1,1655,12,13288,230,3311,4450,0.000364336621374463,8.74649173829422e-06,9.07825521802262e-05,0.000122012188825734
"35333","2020/07/05","MA",36471766,534,2,1945,12,13822,232,3650,4901,0.000378978084033551,1.46414626590881e-05,0.000100077413306501,0.000134377918524702
"35332","2020/07/06","MA",36471766,393,3,2163,14,14215,235,3951,5218,0.000389753542507374,1.07754584738233e-05,0.000108330372595613,0.000143069573324198
"35331","2020/07/07","MA",36471766,114,0,2039,10,14329,235,3422,5255,0.000392879248018865,3.12570551149072e-06,9.38260022835198e-05,0.000144084056691963
"35330","2020/07/08","MA",36471766,0,0,1796,7,14329,235,2991,4716,0.000392879248018865,0,8.20086419725329e-05,0.000129305501685879
"35329","2020/07/09","MA",36471766,442,7,2135,14,14771,242,3138,4970,0.000404998211493241,1.21189634743763e-05,8.6039156974192e-05,0.000136269792913236
"35328","2020/07/10","MA",36471766,178,0,1980,13,14949,242,3072,4972,0.00040987869904627,4.88048755302938e-06,8.42295379938553e-05,0.000136324629852034
"35327","2020/07/11","MA",36471766,379,1,2040,13,15328,243,3276,5156,0.000420270298948507,1.03915999022367e-05,8.98229057512598e-05,0.000141369628221458
"35326","2020/07/12","MA",36471766,214,2,1720,13,15542,245,3252,5278,0.000426137851399902,5.86755245139487e-06,8.91648624856828e-05,0.000144714681488141
"35325","2020/07/13","MA",36471766,203,5,1530,15,15745,250,3212,4838,0.000431703800687907,5.56594928800541e-06,8.80681237097211e-05,0.000132650554952562
"35324","2020/07/14","MA",36471766,191,5,1607,20,15936,255,3300,4598,0.000436940728343124,5.23692765521691e-06,9.04809490168368e-05,0.000126070122296793
"35323","2020/07/15","MA",36471766,161,2,1768,22,16097,257,3128,4464,0.00044135510191637,4.41437357324567e-06,8.57649722802016e-05,0.000122396047397321
"35322","2020/07/16","MA",36471766,165,2,1491,17,16262,259,2974,4385,0.000445879149367212,4.52404745084184e-06,8.15425279927492e-05,0.000120229988314797
"35321","2020/07/17","MA",36471766,162,1,1475,18,16424,260,2602,4372,0.000450320941409857,4.44179204264471e-06,7.13428573763058e-05,0.000119873548212609
"35320","2020/07/18","MA",36471766,302,4,1398,21,16726,264,2511,4436,0.000458601319168367,8.28037775851051e-06,6.88477766609931e-05,0.000121628330254148
"35319","2020/07/19","MA",36471766,289,5,1473,24,17015,269,2686,4482,0.00046652525682469,7.92393765632298e-06,7.36460088058253e-05,0.000122889579846504
"35318","2020/07/20","MA",36471766,221,4,1491,23,17236,273,2907,4600,0.000472584738561878,6.05948173718816e-06,7.97054905430135e-05,0.000126124959235591
"35317","2020/07/21","MA",36471766,326,3,1626,21,17562,276,2791,4593,0.000481523159585966,8.93842102408751e-06,7.65249480927247e-05,0.000125933029949797
"35316","2020/07/22","MA",36471766,180,4,1645,23,17742,280,2793,4454,0.000486458484077793,4.93532449182746e-06,7.65797850315227e-05,0.000122121862703331
"35315","2020/07/23","MA",36471766,220,5,1700,26,17962,285,2634,4140,0.000492490547345582,6.03206326778912e-06,7.22202483970751e-05,0.000113512463312032
"35314","2020/07/24","MA",36471766,302,7,1840,32,18264,292,2722,4049,0.000500770925104093,8.28037775851051e-06,7.46330737041908e-05,0.000111017382596719
"35313","2020/07/25","MA",36471766,570,7,2108,35,18834,299,3089,4505,0.000516399452661546,1.56285275574536e-05,8.4695651973639e-05,0.000123520204642682
"35312","2020/07/26","MA",36471766,811,6,2630,36,19645,305,3709,5316,0.000538635831344169,2.22363786826226e-05,0.000101695103001045,0.000145756583325304
"35311","2020/07/27","MA",36471766,633,8,3042,40,20278,313,4181,5507,0.000555991722473762,1.73558911295932e-05,0.000114636620557392,0.000150993510980521
"35310","2020/07/28","MA",36471766,609,3,3325,40,20887,316,4625,5938,0.000572689570337779,1.66978478640162e-05,0.000126810420970567,0.000162810871291508
"35309","2020/07/29","MA",36471766,500,11,3645,47,21387,327,4963,6059,0.000586398805037299,1.37092346995207e-05,0.000136077863627443,0.000166128506088792
"35308","2020/07/30","MA",36471766,826,7,4251,49,22213,334,5487,6671,0.000609046460760908,2.26476557236082e-05,0.00015044514159254,0.000182908609361005
"35307","2020/07/31","MA",36471766,1046,12,4995,54,23259,346,6244,7514,0.000637726179752305,2.86797189913973e-05,0.000171200922927615,0.000206022379064397
"35306","2020/08/01","MA",36471766,1063,7,5488,54,24322,353,7086,8386,0.000666872012723486,2.91458329711811e-05,0.000194287274161608,0.000229931284380362
"35305","2020/08/02","MA",36471766,693,14,5370,62,25015,367,7453,8918,0.000685873012017022,1.90009992935357e-05,0.000204349852431056,0.000244517910100652
"35304","2020/08/03","MA",36471766,522,15,5259,69,25537,382,7795,9275,0.000700185453043321,1.43124410262996e-05,0.000213726968965528,0.000254306303676109
"35303","2020/08/04","MA",36471766,659,19,5309,85,26196,401,8234,9772,0.00071825422437729,1.80687713339683e-05,0.000225763677031707,0.000267933282967433
"35302","2020/08/05","MA",36471766,1021,16,5830,90,27217,417,8953,10491,0.000746248481633711,2.79942572564213e-05,0.000245477556529618,0.000287647162465344
"35301","2020/08/06","MA",36471766,1283,18,6287,101,28500,435,9666,11485,0.000781426377872681,3.51778962389702e-05,0.000265026925211135,0.000314901121047991
"35300","2020/08/07","MA",36471766,1144,14,6385,103,29644,449,9999,12408,0.000812793106865184,3.13667289925034e-05,0.000274157275521015,0.000340208368303306
"35299","2020/08/08","MA",36471766,1018,12,6340,108,30662,461,10384,13100,0.000840705108713409,2.79120018482242e-05,0.000284713386239646,0.000359181949127443
"35298","2020/08/09","MA",36471766,1345,19,6992,113,32007,480,11120,14265,0.000877582950055119,3.68778413417107e-05,0.000304893379717341,0.000391124465977326
"35297","2020/08/10","MA",36471766,1230,18,7700,116,33237,498,11850,15275,0.00091130766741594,3.3724717360821e-05,0.000324908862378641,0.000418817120070358
"35296","2020/08/11","MA",36471766,826,18,7867,115,34063,516,11850,15799,0.000933955323139549,2.26476557236082e-05,0.000324908862378641,0.000433184398035456
"35295","2020/08/12","MA",36471766,1132,17,7978,116,35195,533,11936,16361,0.000964993030499263,3.10377073597149e-05,0.000327266850746959,0.000448593577837717
"35294","2020/08/13","MA",36471766,1499,23,8194,121,36694,556,12372,17049,0.00100609331612843,4.11002856291631e-05,0.000339221303404941,0.000467457484784258
"35293","2020/08/14","MA",36471766,1241,28,8291,135,37935,584,12920,17657,0.00104011963665264,3.40263205242104e-05,0.000354246624635615,0.000484127914178875
"35292","2020/08/15","MA",36471766,1306,27,8579,150,39241,611,13704,18354,0.00107592815768779,3.58085210351481e-05,0.000375742704644464,0.000503238587350007
"35291","2020/08/16","MA",36471766,1776,21,9010,152,41017,632,14821,19630,0.00112462335934048,4.86952016526976e-05,0.000406369134963193,0.000538224554303183
"35290","2020/08/17","MA",36471766,1472,26,9252,160,42489,658,15272,20276,0.00116498334629587,4.0359986955389e-05,0.000418734864662161,0.000555936885534964
"35289","2020/08/18","MA",36471766,1069,23,9495,165,43558,681,15058,20299,0.00119429369008345,2.93103437875753e-05,0.000412867312210766,0.000556567510331142
"35288","2020/08/19","MA",36471766,1245,33,9608,181,44803,714,15159,20481,0.00122842968448525,3.41359944018066e-05,0.000415636577620069,0.000561557671761768
"35287","2020/08/20","MA",36471766,1510,29,9619,187,46313,743,15651,21298,0.00126983157327781,4.14018887925526e-05,0.000429126464564398,0.000583958561260785
"35286","2020/08/21","MA",36471766,1325,32,9703,191,47638,775,15631,22101,0.00130616104523154,3.63294719537299e-05,0.000428578095176417,0.000605975592188215
"35285","2020/08/22","MA",36471766,1609,42,10006,206,49247,817,16010,23051,0.00135027736249459,4.41163172630577e-05,0.000438969695078653,0.000632023138117304
"35284","2020/08/23","MA",36471766,1565,41,9795,226,50812,858,16749,23595,0.00139318726710409,4.29099046094999e-05,0.000459231943964545,0.000646938785470383
"35283","2020/08/24","MA",36471766,1537,30,9860,230,52349,888,17154,23849,0.00143532945457042,4.21421874663267e-05,0.000470336424071157,0.000653903076697739
"35282","2020/08/25","MA",36471766,903,32,9694,239,53252,920,16558,23608,0.00146008833243775,2.47588778673344e-05,0.000453995016309328,0.00064729522557257
"35281","2020/08/26","MA",36471766,1276,35,9725,241,54528,955,16593,23866,0.00149507429939093,3.49859669531769e-05,0.000454954662738295,0.000654369190677523
"35280","2020/08/27","MA",36471766,1336,29,9551,241,55864,984,16623,23857,0.00153170537450805,3.66310751171194e-05,0.000455777216820266,0.000654122424452932
"35279","2020/08/28","MA",36471766,1221,27,9447,236,57085,1011,16068,23848,0.00156518332564428,3.34779511362296e-05,0.000440559966303798,0.00065387565822834
"35278","2020/08/29","MA",36471766,1404,41,9242,235,58489,1052,16000,24426,0.00160367885668053,3.84955310362542e-05,0.000438695510384663,0.000669723533540986
"35277","2020/08/30","MA",36471766,1567,26,9244,220,60056,1078,16498,24861,0.00164664359822883,4.29647415482979e-05,0.000452349908145386,0.000681650567729569
"35276","2020/08/31","MA",36471766,1343,33,9050,223,61399,1111,16596,24705,0.00168346660263175,3.68230044029127e-05,0.000455036918146492,0.000677373286503319
"35275","2020/09/01","MA",36471766,1191,30,9338,221,62590,1141,16277,24655,0.001716121999686,3.26553970542584e-05,0.000446290426408197,0.000676002363033367
"35274","2020/09/02","MA",36471766,1191,43,9253,229,63781,1184,16143,24540,0.00174877739674026,3.26553970542584e-05,0.000442616351508726,0.000672849239052477
"35273","2020/09/03","MA",36471766,1672,32,9589,232,65453,1216,16206,24436,0.00179462107757546,4.58436808351973e-05,0.000444343715080866,0.000669997718234977
"35272","2020/09/04","MA",36471766,1402,37,9770,242,66855,1253,16043,24366,0.00183306177167292,3.84406940974561e-05,0.000439874504568822,0.000668078425377044
"35271","2020/09/05","MA",36471766,1750,39,10116,240,68605,1292,16256,25047,0.00188104409312124,4.79823214483225e-05,0.000445714638550818,0.000686750403037791
"35270","2020/09/06","MA",36471766,1555,37,10104,251,70160,1329,16908,25357,0.00192367981303675,4.26357199155094e-05,0.000463591480598993,0.000695250128551494
"35269","2020/09/07","MA",36471766,2234,32,10995,250,72394,1361,17866,26081,0.00198493267367421,6.12528606374586e-05,0.000489858374283274,0.0007151011003964
"35268","2020/09/08","MA",36471766,1386,33,11190,253,73780,1394,17916,26142,0.00202293467226128,3.80019985870714e-05,0.000491229297753226,0.000716773627029741
"35267","2020/09/09","MA",36471766,1941,33,11940,243,75721,1427,18636,26474,0.00207615392136482,5.32192491035394e-05,0.000510970595720536,0.000725876558870223
"35266","2020/09/10","MA",36471766,2157,26,12425,237,77878,1453,19389,27066,0.00213529555985855,5.91416384937324e-05,0.000531616703178014,0.000742108292754456
"35265","2020/09/11","MA",36471766,1889,38,12912,238,79767,1491,19711,27418,0.00218708904855334,5.17934886947893e-05,0.000540445450324506,0.000751759593982918
"35264","2020/09/12","MA",36471766,2430,33,13592,232,82197,1524,20798,28945,0.00225371592919301,6.66268806396707e-05,0.000570249326561264,0.000793627596755254
"35263","2020/09/13","MA",36471766,2238,29,14275,224,84435,1553,21845,29907,0.00231507846370806,6.13625345150547e-05,0.00059895646402206,0.000820004164317132
"35262","2020/09/14","MA",36471766,2251,25,14292,217,86686,1578,22905,30822,0.00237679743832531,6.17189746172423e-05,0.000628020041585044,0.000845092063817255
"35261","2020/09/15","MA",36471766,1517,36,14423,220,88203,1614,22750,31118,0.00241839125640365,4.15938180783459e-05,0.000623770178828193,0.000853207930759372
"35260","2020/09/16","MA",36471766,2121,34,14603,221,90324,1648,23469,31835,0.00247654582999902,5.81545735953669e-05,0.000643484058326104,0.000872866973318484
"35259","2020/09/17","MA",36471766,1692,38,14138,233,92016,1686,23411,31960,0.0025229378802222,4.63920502231781e-05,0.000641893787100959,0.000876294281993364
"35258","2020/09/18","MA",36471766,2488,28,14737,223,94504,1714,24344,33105,0.00259115503208701,6.82171518648151e-05,0.000667475219050265,0.000907688429455267
"35257","2020/09/19","MA",36471766,2760,41,15067,231,97264,1755,24870,34674,0.00266683000762837,7.56749755413544e-05,0.000681897333954161,0.000950708007942363
"35256","2020/09/20","MA",36471766,2552,40,15381,242,99816,1795,26036,36035,0.00273680194153472,6.99719339063538e-05,0.000713867269273443,0.000988024544794458
"35255","2020/09/21","MA",36471766,1927,35,15057,252,101743,1830,26022,36290,0.00278963733206667,5.28353905319529e-05,0.000713483410701856,0.000995016254491214
"35254","2020/09/22","MA",36471766,1376,25,14916,241,103119,1855,25241,36264,0.00282736514595975,3.7727813893081e-05,0.000692069586101205,0.000994303374286839
"35253","2020/09/23","MA",36471766,2227,34,15022,241,105346,1889,25579,36741,0.00288842607731142,6.10609313516653e-05,0.000701337028758081,0.00100738198419018
"35252","2020/09/24","MA",36471766,2397,29,15727,232,107743,1918,25546,37583,0.00295414814846092,6.57220711495023e-05,0.000700432219267913,0.00103046833542417
"35251","2020/09/25","MA",36471766,2356,38,15595,242,110099,1956,25664,37705,0.00301874606236506,6.45979139041416e-05,0.000703667598656999,0.00103381338869086
"35250","2020/09/26","MA",36471766,2423,42,15258,243,112522,1998,25836,38742,0.00308518101371894,6.64349513538774e-05,0.000708383575393635,0.00106224634145766
"35249","2020/09/27","MA",36471766,2719,43,15425,246,115241,2041,27038,39520,0.00315973183201493,7.45508182959937e-05,0.000741340575611282,0.00108357791065012
"35248","2020/09/28","MA",36471766,2444,28,15942,239,117685,2069,27361,39807,0.00322674257122619,6.70107392112573e-05,0.000750196741227173,0.00109144701136764
"35247","2020/09/29","MA",36471766,1422,44,15988,258,119107,2113,27091,39340,0.00326573163471163,3.89890634854369e-05,0.000742793754489432,0.00107864258615829
"35246","2020/09/30","MA",36471766,2076,39,15837,263,121183,2152,26679,38986,0.00332265237718404,5.692074247241e-05,0.000731497345097027,0.00106893644799103
"35245","2020/10/01","MA",36471766,2470,42,15910,276,123653,2194,26389,39218,0.00339037599659967,6.77236194156324e-05,0.000723545988971305,0.00107529753289161
"35244","2020/10/02","MA",36471766,2391,35,15945,273,126044,2229,26228,39358,0.00345593355693278,6.55575603331081e-05,0.000719131615398059,0.00107913611860747
"35243","2020/10/03","MA",36471766,2521,34,16043,265,128565,2263,26822,40362,0.00352505551828776,6.91219613549835e-05,0.000735418186221089,0.00110666426188411
"35242","2020/10/04","MA",36471766,2663,30,15987,252,131228,2293,28109,40904,0.00359807090229741,7.30153840096474e-05,0.000770705756337656,0.00112152507229839
"35241","2020/10/05","MA",36471766,2044,37,15587,261,133272,2330,27926,41256,0.00365411425374905,5.60433514516407e-05,0.000765688176437631,0.00113117637352685
"35240","2020/10/06","MA",36471766,1423,39,15588,256,134695,2369,26952,40191,0.00369313073570389,3.9016481954836e-05,0.000738982587242965,0.00110197570361687
"35239","2020/10/07","MA",36471766,2553,41,16065,258,137248,2410,27149,39984,0.00376313008807964,6.99993523757528e-05,0.000744384025714576,0.00109630008045127
"35238","2020/10/08","MA",36471766,2776,29,16371,245,140024,2439,27502,40208,0.00383924375913138,7.6113671051739e-05,0.000754062745412438,0.00110244181759666
"35237","2020/10/09","MA",36471766,2929,47,16909,257,142953,2486,27712,41210,0.00391955245600117,8.03086968697924e-05,0.000759820623986236,0.0011299151239345
"35236","2020/10/10","MA",36471766,3445,44,17833,267,146398,2530,28713,43279,0.00401400908308087,9.44566270796978e-05,0.000787266511854677,0.00118664393712111
"35235","2020/10/11","MA",36471766,3443,42,18613,279,149841,2572,30734,44495,0.00410841087322177,9.44017901408997e-05,0.00084267923851014,0.00121998479591035
"35234","2020/10/12","MA",36471766,2563,33,19132,275,152404,2605,31221,44661,0.00417868441029151,7.02735370697432e-05,0.000856032033107473,0.00122453626183059
"35233","2020/10/13","MA",36471766,1357,31,19066,267,153761,2636,30108,43662,0.00421589127326601,3.72068629744992e-05,0.00082551527666634,0.00119714521090095
"35232","2020/10/14","MA",36471766,3185,49,19698,275,156946,2685,30902,44424,0.00430321909830196,8.7327825035947e-05,0.000847285541369179,0.00121803808458302
"35231","2020/10/15","MA",36471766,3387,41,20309,287,160333,2726,31768,45092,0.00439608545415651,9.28663558545534e-05,0.000871029935868748,0.00123635362214158
"35230","2020/10/16","MA",36471766,3317,46,20697,286,163650,2772,32422,45965,0.00448703251715313,9.09470629966204e-05,0.000888961614855722,0.00126028994592694
"35229","2020/10/17","MA",36471766,3498,46,20750,288,167148,2818,33876,48041,0.00458294232311098,9.59098059578469e-05,0.000928828069361928,0.00131721068839935
"35228","2020/10/18","MA",36471766,3763,60,21070,306,170911,2878,36216,49728,0.00468611802345957,0.000103175700348593,0.000992987287755685,0.00136346564627553
"35227","2020/10/19","MA",36471766,2721,50,21228,323,173632,2928,36384,49979,0.00476072367869436,7.46056552347918e-05,0.000997593590614724,0.00137034768209469
"35226","2020/10/20","MA",36471766,2117,48,21988,340,175749,2976,35725,49705,0.00481876857841213,5.80448997177707e-05,0.000979524819280755,0.00136283502147935
"35225","2020/10/21","MA",36471766,3254,51,22057,342,179003,3027,36050,50438,0.00490798827783662,8.92196994244808e-05,0.000988435821835444,0.00138293275954885
"35224","2020/10/22","MA",36471766,3577,70,22247,371,182580,3097,36182,51352,0.00500606414287699,9.80758650403712e-05,0.000992055059796117,0.00140799324057958
"35223","2020/10/23","MA",36471766,4151,35,23081,360,186731,3132,36890,53459,0.00511987820935241,0.000113814066475421,0.00101146733613064,0.00146576395560336
"35222","2020/10/24","MA",36471766,3685,73,23268,387,190416,3205,38012,55721,0.00522091526908787,0.000101037059735468,0.00104223085879636,0.00152778453338399
"35221","2020/10/25","MA",36471766,4045,50,23550,377,194461,3255,40700,57213,0.005331822977807,0.000110907708719123,0.00111593170454099,0.00156869288972736
"35220","2020/10/26","MA",36471766,3020,46,23849,373,197481,3301,40535,57457,0.0054146267553921,8.28037775851052e-05,0.00111140765709014,0.00157538299626072
"35219","2020/10/27","MA",36471766,2264,72,23996,397,199745,3373,39412,56792,0.00547670217011153,6.20754147194298e-05,0.00108061671595502,0.00155714971411036
"35218","2020/10/28","MA",36471766,3988,72,24730,418,203733,3445,40083,57335,0.00558604702607491,0.000109344855963377,0.00109901450892178,0.00157203794299404
"35217","2020/10/29","MA",36471766,3985,61,25138,409,207718,3506,40570,57877,0.00569530962663009,0.00010926260055518,0.00111236730351911,0.00158689875340832
"35216","2020/10/30","MA",36471766,4320,66,25307,440,212038,3572,41127,59634,0.00581375741443395,0.000118447787803859,0.00112763939097438,0.00163507300414244
"35215","2020/10/31","MA",36471766,3256,53,24878,420,215294,3625,41662,61533,0.00590303195079723,8.92745363632789e-05,0.00114230827210286,0.00168714067753122
"35214","2020/11/01","MA",36471766,3790,70,24623,440,219084,3695,43335,62138,0.00600694794981959,0.000103915999022367,0.00118817937140746,0.00170372885151764
"35213","2020/11/02","MA",36471766,3460,67,25063,461,222544,3762,43541,62211,0.00610181585394028,9.48679041206834e-05,0.00119382757610366,0.00170573039978377
"35212","2020/11/03","MA",36471766,2526,64,25325,453,225070,3826,42490,61420,0.00617107490764226,6.92590537019787e-05,0.00116501076476527,0.00168404239048913
"35211","2020/11/04","MA",36471766,4495,74,25832,455,229565,3900,42834,62417,0.00629432092759095,0.000123246019948691,0.00117444271823854,0.00171137860447997
"35210","2020/11/05","MA",36471766,5745,82,27592,476,235310,3982,44894,64399,0.00645184003428844,0.000157519106697493,0.00123092476520057,0.00176572201082887
"35209","2020/11/06","MA",36471766,5641,77,28913,487,240951,4059,46490,67319,0.00660650762016843,0.000154667585879993,0.00127468464236144,0.00184578394147407
"35208","2020/11/07","MA",36471766,5398,68,31055,502,246349,4127,48868,70600,0.00675451251798446,0.000148004897816026,0.00133988576259236,0.00193574393957233
"35207","2020/11/08","MA",36471766,5836,70,33101,502,252185,4197,52440,73182,0.00691452670539727,0.000160014187412806,0.00143782453528573,0.00200653842756065
"35206","2020/11/09","MA",36471766,4596,75,34237,510,256781,4272,53048,74201,0.00704054199075526,0.000126015285357994,0.00145449496468035,0.00203447784787827
"35205","2020/11/10","MA",36471766,3170,84,34881,530,259951,4356,52233,73220,0.00712745853875022,8.69165479949614e-05,0.00143214891212013,0.00200758032939781
"35204","2020/11/11","MA",36471766,5214,69,35600,525,265165,4425,53127,74749,0.00727041843819682,0.000142959899446602,0.00145666102376287,0.00204950316910895
"35203","2020/11/12","MA",36471766,5461,81,35316,524,270626,4506,55332,76165,0.00742015069958499,0.000149732261388165,0.00151711874878776,0.00208832772177799
"35202","2020/11/13","MA",36471766,6195,64,35870,511,276821,4570,57737,79340,0.00759000811751205,0.000169857417927062,0.00158306016769246,0.00217538136211995
"35201","2020/11/14","MA",36471766,5515,61,35987,504,282336,4631,59792,82591,0.00774122097624776,0.000151212858735714,0.00163940512230749,0.00226451880613623
"35200","2020/11/15","MA",36471766,5875,66,36026,500,288211,4697,63141,84478,0.00790230448396713,0.000161083507719368,0.00173122957632488,0.00231625745789222
"35199","2020/11/16","MA",36471766,4966,82,36396,507,293177,4779,63612,85459,0.00803846460300277,0.00013616011903564,0.00174414367541182,0.00234315497637268
"35198","2020/11/17","MA",36471766,3012,71,36238,494,296189,4850,60879,84151,0.00812104903283268,8.25844298299128e-05,0.00166920899854424,0.00230729161839874
"35197","2020/11/18","MA",36471766,5415,82,36439,507,301604,4932,60653,86310,0.00826952004462849,0.000148471011795809,0.00166301242446006,0.00236648809383127
"35196","2020/11/19","MA",36471766,5391,81,36369,507,306995,5013,60646,87911,0.00841733301315873,0.000147812968530232,0.00166282049517427,0.00241038506333913
"35195","2020/11/20","MA",36471766,4559,77,34733,520,311554,5090,59369,89010,0.00854233381514896,0.00012500080199023,0.00162780710975169,0.00244051796120868
"35194","2020/11/21","MA",36471766,4706,92,33924,551,316260,5182,59479,91190,0.00867136513214085,0.000129031316991889,0.00163082314138559,0.00250029022449859
"35193","2020/11/22","MA",36471766,4702,74,32751,559,320962,5256,61011,91397,0.00880028677525514,0.000128921643114293,0.00167282823650492,0.00250596584766419
"35192","2020/11/23","MA",36471766,0,0,27785,477,320962,5256,55797,85652,0.00880028677525514,0,0.00152986833705832,0.0023484467409667
"35191","2020/11/24","MA",36471766,6566,140,31339,546,327528,5396,56902,86577,0.00898031644532924,0.000180029670074106,0.00156016574574426,0.00237380882516081
"35190","2020/11/25","MA",36471766,3999,73,29923,537,331527,5469,54706,85178,0.00908996290445601,0.000109646459126767,0.00149995478694396,0.00233545038647155
