"","date","countrycode","population","cases","deaths","cases_prev_week","deaths_prev_week","cases_infected","cum_deaths","cases_contagious","cases_active","p_cases_infected","p_cases","p_cases_contagious","p_cases_active"
"40312","2020/03/10","PA",4246440,1,0,1,0,1,0,1,1,2.354913763058e-07,2.354913763058e-07,2.354913763058e-07,2.354913763058e-07
"40311","2020/03/11","PA",4246440,6,1,7,1,7,1,7,7,1.6484396341406e-06,1.4129482578348e-06,1.6484396341406e-06,1.6484396341406e-06
"40310","2020/03/12","PA",4246440,7,0,14,1,14,1,14,14,3.2968792682812e-06,1.6484396341406e-06,3.2968792682812e-06,3.2968792682812e-06
"40309","2020/03/13","PA",4246440,13,0,27,1,27,1,27,27,6.35826716025659e-06,3.0613878919754e-06,6.35826716025659e-06,6.35826716025659e-06
"40308","2020/03/14","PA",4246440,9,0,36,1,36,1,36,36,8.47768954700879e-06,2.1194223867522e-06,8.47768954700879e-06,8.47768954700879e-06
"40307","2020/03/15","PA",4246440,7,0,43,1,43,1,43,43,1.01261291811494e-05,1.6484396341406e-06,1.01261291811494e-05,1.01261291811494e-05
"40306","2020/03/16","PA",4246440,0,0,43,1,43,1,43,43,1.01261291811494e-05,0,1.01261291811494e-05,1.01261291811494e-05
"40305","2020/03/17","PA",4246440,26,0,68,1,69,1,69,69,1.62489049651002e-05,6.12277578395079e-06,1.62489049651002e-05,1.62489049651002e-05
"40304","2020/03/18","PA",4246440,17,0,79,0,86,1,86,86,2.02522583622988e-05,4.00335339719859e-06,2.02522583622988e-05,2.02522583622988e-05
"40303","2020/03/19","PA",4246440,23,0,95,0,109,1,109,109,2.56685600173322e-05,5.41630165503339e-06,2.56685600173322e-05,2.56685600173322e-05
"40302","2020/03/20","PA",4246440,28,0,110,0,137,1,137,137,3.22623185538946e-05,6.59375853656239e-06,3.22623185538946e-05,3.22623185538946e-05
"40301","2020/03/21","PA",4246440,63,0,164,0,200,1,200,200,4.70982752611599e-05,1.48359567072654e-05,4.70982752611599e-05,4.70982752611599e-05
"40300","2020/03/22","PA",4246440,45,2,202,2,245,3,244,245,5.76953871949209e-05,1.0597111933761e-05,5.74598958186151e-05,5.76953871949209e-05
"40299","2020/03/23","PA",4246440,68,0,270,2,313,3,306,313,7.37088007837153e-05,1.60134135887944e-05,7.20603611495747e-05,7.37088007837153e-05
"40298","2020/03/24","PA",4246440,32,3,276,5,345,6,331,345,8.12445248255009e-05,7.53572404178559e-06,7.79476455572197e-05,8.12445248255009e-05
"40297","2020/03/25","PA",4246440,98,0,357,5,443,6,416,443,0.000104322679703469,2.30781548779684e-05,9.79644125432127e-05,0.000104322679703469
"40296","2020/03/26","PA",4246440,145,0,479,5,588,6,552,588,0.00013846892926781,3.4146249564341e-05,0.000129991239720801,0.00013846892926781
"40295","2020/03/27","PA",4246440,86,3,537,8,674,9,631,674,0.000158721187630109,2.02522583622988e-05,0.00014859505844896,0.000158721187630109
"40294","2020/03/28","PA",4246440,112,5,586,13,786,14,743,785,0.000185096221776359,2.63750341462496e-05,0.000174970092595209,0.000184860730400053
"40293","2020/03/29","PA",4246440,115,3,656,14,901,17,832,894,0.000212177730051526,2.7081508275167e-05,0.000195928825086425,0.000210529290417385
"40292","2020/03/30","PA",4246440,88,7,676,21,989,24,903,975,0.000232900971166436,2.07232411149104e-05,0.000212648712804137,0.000229604091898155
"40291","2020/03/31","PA",4246440,86,2,730,20,1075,26,966,1048,0.000253153229528735,2.02522583622988e-05,0.000227484669511403,0.000246794962368478
"40290","2020/04/01","PA",4246440,106,4,738,24,1181,30,1044,1145,0.000278115315417149,2.49620858884148e-05,0.000245852996863255,0.000269637625870141
"40289","2020/04/02","PA",4246440,136,2,729,26,1317,32,1117,1274,0.000310142142594738,3.20268271775888e-05,0.000263043867333578,0.000300016013413589
"40288","2020/04/03","PA",4246440,158,5,801,28,1475,37,1230,1432,0.000347349780051055,3.72076374563163e-05,0.000289654392856134,0.000337223650869905
"40287","2020/04/04","PA",4246440,198,4,887,27,1673,41,1360,1604,0.000393977072559603,4.66272925085483e-05,0.000320268271775888,0.000377728167594503
"40286","2020/04/05","PA",4246440,128,5,900,29,1801,46,1456,1715,0.000424119968726745,3.01428961671424e-05,0.000342875443901244,0.000403867710364446
"40285","2020/04/06","PA",4246440,187,8,999,30,1988,54,1545,1879,0.00046815685609593,4.40368873691845e-05,0.000363834176392461,0.000442488296078598
"40284","2020/04/07","PA",4246440,112,1,1025,29,2100,55,1512,1963,0.000494531890242179,2.63750341462496e-05,0.000356062960974369,0.000462269571688285
"40283","2020/04/08","PA",4246440,149,4,1068,29,2249,59,1575,2049,0.000529620105311743,3.50882150695642e-05,0.000370898917681634,0.000482521830050584
"40282","2020/04/09","PA",4246440,279,4,1211,31,2528,63,1742,2283,0.000595322199301062,6.57020939893181e-05,0.000410225977524703,0.000537626812106141
"40281","2020/04/10","PA",4246440,224,3,1277,29,2752,66,1851,2439,0.000648072267593561,5.27500682924991e-05,0.000435894537542035,0.000574363466809845
"40280","2020/04/11","PA",4246440,222,8,1301,33,2974,74,1985,2629,0.000700351353133448,5.22790855398875e-05,0.000467450381967012,0.000619106828307947
"40279","2020/04/12","PA",4246440,260,5,1433,33,3234,79,2159,2791,0.000761579110972956,6.12277578395079e-05,0.000508425881444221,0.000657256431269487
"40278","2020/04/13","PA",4246440,166,8,1412,33,3400,87,2219,2812,0.000800670679439719,3.90915684667627e-05,0.00052255536402257,0.000662201750171909
"40277","2020/04/14","PA",4246440,72,7,1372,39,3472,94,2155,2798,0.000817626058533736,1.69553790940176e-05,0.000507483915938998,0.000658904870903628
"40276","2020/04/15","PA",4246440,102,1,1325,36,3574,95,2099,2788,0.000841646178916928,2.40201203831916e-05,0.000494296398865874,0.000656549957140569
"40275","2020/04/16","PA",4246440,177,8,1223,40,3751,103,2078,2850,0.000883328152523055,4.16819736061265e-05,0.000489351079963452,0.000671150422471529
"40274","2020/04/17","PA",4246440,265,6,1264,43,4016,109,2215,3027,0.000945733367244092,6.24052147210369e-05,0.000521613398517346,0.000712832396077656
"40273","2020/04/18","PA",4246440,194,7,1236,42,4210,116,2222,3135,0.000991418694247417,4.56853270033251e-05,0.000523261838151487,0.000738265464718682
"40272","2020/04/19","PA",4246440,63,4,1039,41,4273,120,2173,3092,0.00100625465095468,1.48359567072654e-05,0.000511722760712503,0.000728139335537533
"40271","2020/04/20","PA",4246440,194,6,1067,39,4467,126,2218,3150,0.00105193997795801,4.56853270033251e-05,0.000522319872646264,0.000741797835363269
"40270","2020/04/21","PA",4246440,191,10,1186,42,4658,136,2130,3183,0.00109691883083241,4.49788528744077e-05,0.000501596631531353,0.00074956905078136
"40269","2020/04/22","PA",4246440,163,5,1247,46,4821,141,2069,3148,0.00113530392517026,3.83850943378453e-05,0.0004872316575767,0.000741326852610657
"40268","2020/04/23","PA",4246440,171,3,1241,41,4992,144,2018,3191,0.00117557295051855,4.02690253482917e-05,0.000475221597385104,0.000751452981791807
"40267","2020/04/24","PA",4246440,174,2,1150,37,5166,146,1932,3178,0.00121654844999576,4.09754994772091e-05,0.000454969339022805,0.000748391593899831
"40266","2020/04/25","PA",4246440,172,8,1128,38,5338,154,1938,3238,0.00125705296672036,4.05045167245975e-05,0.00045638228728064,0.000762521076478179
"40265","2020/04/26","PA",4246440,200,5,1265,39,5538,159,2066,3289,0.00130415124198152,4.70982752611599e-05,0.000486525183447782,0.000774531136669775
"40264","2020/04/27","PA",4246440,241,6,1312,39,5779,165,2205,3251,0.00136090466367122,5.67534216896977e-05,0.000519258484754288,0.000765582464370155
"40263","2020/04/28","PA",4246440,242,2,1363,31,6021,167,2270,3269,0.00141789357673722,5.69889130660035e-05,0.000534565424214165,0.000769821309143659
"40262","2020/04/29","PA",4246440,179,9,1379,35,6200,176,2184,3226,0.00146004653309596,4.21529563587381e-05,0.000514313165851866,0.00075969517996251
"40261","2020/04/30","PA",4246440,178,2,1386,34,6378,178,2168,3144,0.00150196399807839,4.19174649824323e-05,0.000510545303830974,0.000740384887105434
"40260","2020/05/01","PA",4246440,154,10,1366,42,6532,188,2259,3132,0.00153822967002948,3.62656719510931e-05,0.000531975019074801,0.000737558990589765
"40259","2020/05/02","PA",4246440,188,4,1382,38,6720,192,2253,3248,0.00158250204877497,4.42723787454903e-05,0.000530562070816967,0.000764875990241237
"40258","2020/05/03","PA",4246440,370,5,1552,38,7090,197,2432,3516,0.00166963385800812,8.71318092331459e-05,0.000572715027175705,0.000827987679091192
"40257","2020/05/04","PA",4246440,107,3,1418,35,7197,200,2376,3446,0.00169483143527284,2.51975772647206e-05,0.00055952751010258,0.000811503282749786
"40256","2020/05/05","PA",4246440,190,3,1366,36,7387,203,2395,3371,0.00173957479677094,4.47433614981019e-05,0.00056400184625239,0.000793841429526851
"40255","2020/05/06","PA",4246440,136,7,1323,34,7523,210,2357,3313,0.00177160162394853,3.20268271775888e-05,0.00055505317395277,0.000780182929701114
"40254","2020/05/07","PA",4246440,208,8,1353,40,7731,218,2393,3458,0.00182058383022014,4.89822062716063e-05,0.000563530863499779,0.000814329179265455
"40253","2020/05/08","PA",4246440,137,7,1336,37,7868,225,2330,3401,0.00185284614877403,3.22623185538946e-05,0.000548694906792513,0.000800906170816025
"40252","2020/05/09","PA",4246440,202,6,1350,39,8070,231,2291,3412,0.0019004154067878,4.75692580137715e-05,0.000539510743116587,0.000803496575955389
"40251","2020/05/10","PA",4246440,212,6,1192,40,8282,237,2261,3461,0.00195033957856463,4.99241717768295e-05,0.000532446001827413,0.000815035653394373
"40250","2020/05/11","PA",4246440,166,7,1251,44,8448,244,2248,3456,0.0019894311470314,3.90915684667627e-05,0.000529384613935438,0.000813858196512844
"40249","2020/05/12","PA",4246440,168,5,1229,46,8616,249,2238,3450,0.00202899369825077,3.95625512193743e-05,0.00052702970017238,0.000812445248255009
"40248","2020/05/13","PA",4246440,167,3,1260,42,8783,252,2251,3445,0.00206832075809384,3.93270598430685e-05,0.000530091088064355,0.00081126779137348
"40247","2020/05/14","PA",4246440,161,4,1213,38,8944,256,2224,3406,0.00210623486967907,3.79141115852337e-05,0.000523732820904098,0.000802083627697554
"40246","2020/05/15","PA",4246440,174,4,1250,35,9118,260,2028,3339,0.00214721036915628,4.09754994772091e-05,0.000477576511148162,0.000786305705485065
"40245","2020/05/16","PA",4246440,150,6,1198,35,9268,266,2071,3247,0.00218253407560215,3.53237064458699e-05,0.000487702640329311,0.000764640498864932
"40244","2020/05/17","PA",4246440,181,3,1167,32,9449,269,2062,3249,0.0022251580147135,4.26239391113497e-05,0.000485583217942559,0.000765111481617543
"40243","2020/05/18","PA",4246440,157,6,1158,31,9606,275,2083,3228,0.00226213016079351,3.69721460800106e-05,0.000490528536844981,0.000760166162715121
"40242","2020/05/19","PA",4246440,120,4,1110,30,9726,279,1995,3194,0.00229038912595021,2.8258965156696e-05,0.00046980529573007,0.000752159455920724
"40241","2020/05/20","PA",4246440,141,2,1084,29,9867,281,1999,3147,0.00232359341000933,3.32042840591178e-05,0.000470747261235294,0.000741091361234352
"40240","2020/05/21","PA",4246440,110,6,1033,31,9977,287,1907,2887,0.00234949746140296,2.5904051393638e-05,0.00044908205461516,0.000679863603394844
"40239","2020/05/22","PA",4246440,139,4,998,31,10116,291,1834,2919,0.00238223076270947,3.27333013065062e-05,0.000431891184144837,0.000687399327436629
"40238","2020/05/23","PA",4246440,151,4,999,29,10267,295,1819,2880,0.00241778996053165,3.55591978221758e-05,0.00042835881350025,0.000678215163760703
"40237","2020/05/24","PA",4246440,310,4,1128,30,10577,299,1961,3054,0.00249079228718644,7.30023266547979e-05,0.000461798588935673,0.000719190663237912
"40236","2020/05/25","PA",4246440,349,7,1320,31,10926,306,2143,3195,0.00257297877751717,8.21864903307241e-05,0.000504658019423329,0.00075239494729703
"40235","2020/05/26","PA",4246440,257,4,1457,31,11183,310,2239,3315,0.00263350006122776,6.05212837105905e-05,0.000527265191548686,0.000780653912453726
"40234","2020/05/27","PA",4246440,264,3,1580,32,11447,313,2329,3377,0.00269566978457249,6.21697233447311e-05,0.000548459415416207,0.000795254377784685
"40233","2020/05/28","PA",4246440,281,2,1751,28,11728,315,2460,3446,0.00276184286131442,6.61730767419297e-05,0.000579308785712267,0.000811503282749786
"40232","2020/05/29","PA",4246440,403,5,2015,29,12131,320,2682,3683,0.00285674588596566,9.49030246512373e-05,0.000631587871252155,0.00086731473893426
"40231","2020/05/30","PA",4246440,400,6,2264,31,12531,326,2925,3915,0.00295094243648798,9.41965505223199e-05,0.000688812275694464,0.000921948738237206
"40230","2020/05/31","PA",4246440,487,4,2441,31,13018,330,3292,4235,0.0030656267367489,0.000114684300260924,0.000775237610798693,0.000997305978655062
"40229","2020/06/01","PA",4246440,445,6,2537,30,13463,336,3596,4519,0.00317042039920498,0.000104793662456081,0.000846826989195656,0.00106418552952591
"40228","2020/06/02","PA",4246440,374,8,2654,34,13837,344,3860,4719,0.00325849417394335,8.80737747383691e-05,0.000908996712540387,0.00111128380478707
"40227","2020/06/03","PA",4246440,258,8,2648,39,14095,352,3979,4827,0.00331925094903025,6.07567750868963e-05,0.000937020186320777,0.0011367168734281
"40226","2020/06/04","PA",4246440,514,5,2881,42,14609,357,4342,5160,0.00344029351645143,0.000121042567421181,0.00102250355591978,0.00121513550173793
"40225","2020/06/05","PA",4246440,435,6,2913,43,15044,363,4467,5438,0.00354273226514445,0.000102438748693023,0.00105193997795801,0.00128060210435094
"40224","2020/06/06","PA",4246440,419,7,2932,44,15463,370,4537,5737,0.00364140315181658,9.86708866721301e-05,0.00106842437429941,0.00135101402586637
"40223","2020/06/07","PA",4246440,541,16,2986,56,16004,386,4821,6137,0.00376880398639802,0.000127400834581438,0.00113530392517026,0.00144521057638869
"40222","2020/06/08","PA",4246440,421,7,2962,57,16425,393,4978,6448,0.00386794585582276,9.91418694247417e-05,0.00117227607125027,0.0015184483944198
"40221","2020/06/09","PA",4246440,429,5,3017,54,16854,398,5126,6738,0.00396897165625795,0.000101025800435188,0.00120712879494353,0.00158674089354848
"40220","2020/06/10","PA",4246440,379,5,3138,51,17233,403,5102,6966,0.00405822288787785,8.92512316198981e-05,0.00120147700191219,0.0016404329273462
"40219","2020/06/11","PA",4246440,656,10,3280,56,17889,413,5358,7312,0.00421270523073445,0.000154482342856605,0.00126176279424647,0.00172191294354801
"40218","2020/06/12","PA",4246440,697,5,3542,55,18586,418,5568,7660,0.00437684272001959,0.000164137489285142,0.00131121598327069,0.00180386394250243
"40217","2020/06/13","PA",4246440,625,3,3748,51,19211,421,5748,8028,0.00452402483021072,0.000147182110191125,0.00135360443100574,0.00189052476898296
"40216","2020/06/14","PA",4246440,848,8,4055,43,20059,429,6222,8612,0.00472372151731804,0.000199696687107318,0.00146522734337469,0.00202805173274555
"40215","2020/06/15","PA",4246440,627,8,4261,44,20686,437,6591,8958,0.00487137461026177,0.000147653092943736,0.00155212366123153,0.00210953174894735
"40214","2020/06/16","PA",4246440,736,11,4568,50,21422,448,6813,9291,0.00504469626322284,0.000173321652961069,0.00160440274677141,0.00218795037725718
"40213","2020/06/17","PA",4246440,540,9,4729,54,21962,457,6918,9431,0.00517186160642797,0.000127165343205132,0.00162912934128352,0.00222091916994
"40212","2020/06/18","PA",4246440,635,13,4708,57,22597,470,7134,9579,0.00532139863038216,0.000149537023954183,0.00167999547856557,0.00225577189363326
"40211","2020/06/19","PA",4246440,754,5,4765,57,23351,475,7347,9888,0.00549895912811673,0.000177560497734573,0.00173015514171871,0.00232853872891175
"40210","2020/06/20","PA",4246440,923,10,5063,64,24274,485,7849,10437,0.00571631766844698,0.000217358540330253,0.00184837181262422,0.00245782349450363
"40209","2020/06/21","PA",4246440,948,8,5163,64,25222,493,8368,11127,0.00593956349318488,0.000223245824737898,0.00197059183692693,0.00262031254415463
"40208","2020/06/22","PA",4246440,808,8,5344,64,26030,501,8797,11421,0.00612984052523997,0.000190277032055086,0.00207161763736212,0.00268954700878854
"40207","2020/06/23","PA",4246440,722,20,5330,73,26752,521,8863,11708,0.00629986529893275,0.000170024773692787,0.0020871600681983,0.0027571330337883
"40206","2020/06/24","PA",4246440,562,15,5352,79,27314,536,8728,11851,0.00643221145241661,0.000132346153483859,0.00205536873239702,0.00279080830060003
"40205","2020/06/25","PA",4246440,716,11,5433,77,28030,547,8819,12026,0.00660082327785157,0.000168611825434953,0.00207679844764085,0.00283201929145355
"40204","2020/06/26","PA",4246440,1007,17,5686,89,29037,564,8978,12612,0.00683796309379151,0.00023713981593994,0.00211424157647347,0.00297001723796875
"40203","2020/06/27","PA",4246440,868,11,5631,90,29905,575,9219,13051,0.00704236960842494,0.000204406514633434,0.00217099499816317,0.00307339795216699
"40202","2020/06/28","PA",4246440,753,17,5436,99,30658,592,9236,13425,0.00721969461478321,0.000177325006358267,0.00217499835156037,0.00316147172690536
"40201","2020/06/29","PA",4246440,1028,12,5656,103,31686,604,9724,13797,0.00746177974962557,0.000242085134842362,0.0022899181431976,0.00324907451889112
"40200","2020/06/30","PA",4246440,1099,16,6033,99,32785,620,10188,14199,0.00772058477218564,0.000258805022560074,0.00239918614180349,0.00334374205216605
"40199","2020/07/01","PA",4246440,765,11,6236,95,33550,631,10199,14339,0.00790073567505958,0.000180150902873937,0.00240177654694285,0.00337671084484886
"40198","2020/07/02","PA",4246440,913,14,6433,98,34463,645,10189,14404,0.00811573930162677,0.000215003626567195,0.00239942163317979,0.00339201778430874
"40197","2020/07/03","PA",4246440,774,22,6200,103,35237,667,10015,14551,0.00829800962688746,0.000182270325260689,0.00235844613370258,0.00342663501662569
"40196","2020/07/04","PA",4246440,758,31,6090,123,35995,698,9965,14573,0.00847651209012726,0.000178502463239796,0.00234667156488729,0.00343181582690442
"40195","2020/07/05","PA",4246440,988,22,6325,128,36983,720,10231,15021,0.00870917756991739,0.00023266547979013,0.00240931227098464,0.00353731596348942
"40194","2020/07/06","PA",4246440,1166,27,6463,143,38149,747,10835,15552,0.00898376051468995,0.000274582944772562,0.00255154906227334,0.0036623618843078
"40193","2020/07/07","PA",4246440,1185,23,6549,150,39334,770,11304,15983,0.00926281779561232,0.000279057280922373,0.00266199451776076,0.0037638586674956
"40192","2020/07/08","PA",4246440,957,29,6741,168,40291,799,11254,16017,0.00948818304273697,0.00022536524712465,0.00265021994894547,0.00377186537428999
"40191","2020/07/09","PA",4246440,960,20,6788,174,41251,819,11346,16029,0.00971425476399054,0.000226071721253568,0.0026718851555656,0.00377469127080566
"40190","2020/07/10","PA",4246440,965,20,6979,172,42216,839,11558,16186,0.00994150394212564,0.000227249178135097,0.00272180932734243,0.00381166341688567
"40189","2020/07/11","PA",4246440,1041,24,7262,165,43257,863,11571,16505,0.01018665046486,0.000245146522734337,0.00272487071523441,0.00388678516592722
"40188","2020/07/12","PA",4246440,1075,30,7349,173,44332,893,11547,17018,0.0104398036943887,0.000253153229528735,0.00271921892220307,0.0040075922419721
"40187","2020/07/13","PA",4246440,1301,16,7484,162,45633,909,12083,17603,0.0107461779749626,0.000306374280573845,0.00284544229990298,0.00414535469711099
"40186","2020/07/14","PA",4246440,1540,23,7839,162,47173,932,12710,18136,0.0111088346944735,0.000362656719510932,0.00299309539284671,0.00427087160068198
"40185","2020/07/15","PA",4246440,923,28,7805,161,48096,960,12859,18191,0.0113261932348037,0.000217358540330253,0.00302818360791628,0.0042838236263788
"40184","2020/07/16","PA",4246440,1147,22,7992,163,49243,982,13248,18585,0.0115963018434265,0.000270108608622752,0.00311978975329923,0.00437660722864329
"40183","2020/07/17","PA",4246440,1130,18,8157,161,50373,1000,13390,18687,0.011862407098652,0.000266105255225554,0.00315322952873466,0.00440062734902648
"40182","2020/07/18","PA",4246440,1035,38,8151,175,51408,1038,13259,18623,0.0121061406731286,0.000243733574476503,0.0031223801584386,0.00438555590094291
"40181","2020/07/19","PA",4246440,853,33,7929,178,52261,1071,12927,18711,0.0123070148171174,0.000200874143988847,0.00304419702150507,0.00440627914205782
"40180","2020/07/20","PA",4246440,1207,25,7835,187,53468,1096,13177,19005,0.0125912529083185,0.0002842380912011,0.00310306986558152,0.00447551360669172
"40179","2020/07/21","PA",4246440,958,31,7253,195,54426,1127,13175,19189,0.0128168536468195,0.000225600738500956,0.00310259888282891,0.00451884401993199
"40178","2020/07/22","PA",4246440,727,32,7057,199,55153,1159,12937,19158,0.0129880558773938,0.000171202230574316,0.00304655193526813,0.00451154378726651
"40177","2020/07/23","PA",4246440,753,21,6663,198,55906,1180,12649,18923,0.013165380883752,0.000177325006358267,0.00297873041889206,0.00445620331383465
"40176","2020/07/24","PA",4246440,911,29,6444,209,56817,1209,12485,18668,0.0133799135275666,0.000214532643814584,0.00294010983317791,0.00439615301287667
"40175","2020/07/25","PA",4246440,1176,41,6585,212,57993,1250,12360,18659,0.0136568513861022,0.00027693785853562,0.00291067341113968,0.00439403359048992
"40174","2020/07/26","PA",4246440,871,25,6603,204,58864,1275,11691,18573,0.0138619643748646,0.000205112988762352,0.0027531296803911,0.00437378133212762
"40173","2020/07/27","PA",4246440,1432,19,6828,198,60296,1294,12200,19045,0.0141991880257345,0.000337223650869905,0.00287299479093076,0.00448493326174395
"40172","2020/07/28","PA",4246440,1146,28,7016,195,61442,1322,12199,19226,0.0144690611429809,0.000269873117246446,0.00287275929955445,0.0045275572008553
"40171","2020/07/29","PA",4246440,781,27,7070,190,62223,1349,11850,18966,0.0146529799078758,0.00018391876489483,0.00279057280922373,0.0044663294430158
"40170","2020/07/30","PA",4246440,1046,25,7363,194,63269,1374,11861,18937,0.0148993038874916,0.000246323979615866,0.00279316321436309,0.00445950019310293
"40169","2020/07/31","PA",4246440,922,23,7374,188,64191,1397,11930,18558,0.0151164269364456,0.000217123048953947,0.00280941211932819,0.00437024896148303
"40168","2020/08/01","PA",4246440,1065,24,7263,171,65256,1421,11788,18083,0.0153672252522113,0.000250798315765677,0.00277597234389277,0.00425839055773778
"40167","2020/08/02","PA",4246440,1127,28,7519,174,66383,1449,11957,18287,0.0156326240333079,0.000265398781096636,0.00281577038648845,0.00430643079850416
"40166","2020/08/03","PA",4246440,1070,22,7157,177,67453,1471,12300,18210,0.0158845998059551,0.000251975772647206,0.00289654392856134,0.00428829796252861
"40165","2020/08/04","PA",4246440,1003,26,7014,175,68456,1497,12550,18083,0.0161207976563898,0.000236197850434717,0.00295541677263779,0.00425839055773778
"40164","2020/08/05","PA",4246440,968,25,7201,173,69424,1522,12607,18016,0.0163487533086538,0.000227955652264014,0.00296883978108722,0.00424261263552529
"40163","2020/08/06","PA",4246440,807,31,6962,179,70231,1553,12238,17970,0.0165387948493326,0.00019004154067878,0.00288194346323038,0.00423178003221522
"40162","2020/08/07","PA",4246440,1187,21,7227,177,71418,1574,12554,17950,0.0168183231130076,0.000279528263674984,0.00295635873814301,0.0042270702046891
"40161","2020/08/08","PA",4246440,1142,17,7304,170,72560,1591,12264,18134,0.0170872542647488,0.000268931151741223,0.00288806623901433,0.00427040061792937
"40160","2020/08/09","PA",4246440,1091,18,7268,160,73651,1609,12209,18498,0.0173441753562985,0.000256921091549627,0.00287511421331751,0.00435611947890468
"40159","2020/08/10","PA",4246440,841,30,7039,168,74492,1639,12269,18586,0.0175422236037716,0.000198048247473178,0.00288924369589586,0.00437684272001959
"40158","2020/08/11","PA",4246440,902,25,6938,167,75394,1664,12125,18577,0.0177546368251995,0.000212413221427831,0.00285533293770782,0.00437472329763284
"40157","2020/08/12","PA",4246440,1070,16,7040,158,76464,1680,12273,18471,0.0180066125978467,0.000251975772647206,0.00289018566140108,0.00434976121174443
"40156","2020/08/13","PA",4246440,913,23,7146,150,77377,1703,12121,18513,0.0182216162244139,0.000215003626567195,0.0028543909722026,0.00435965184954927
"40155","2020/08/14","PA",4246440,1069,19,7028,148,78446,1722,12063,18150,0.0184733565056848,0.0002517402812709,0.00284073247237686,0.00427416847995026
"40154","2020/08/15","PA",4246440,956,12,6842,143,79402,1734,11949,17960,0.0186984862614331,0.000225129755748344,0.002813886455478,0.00422942511845216
"40153","2020/08/16","PA",4246440,1263,12,7014,137,80665,1746,12209,18442,0.0189959118697073,0.000297425608274225,0.00287511421331751,0.00434293196183156
"40152","2020/08/17","PA",4246440,1275,21,7448,128,81940,1767,12516,18671,0.0192961633744972,0.000300251504789895,0.00294741006584339,0.00439685948700559
"40151","2020/08/18","PA",4246440,603,21,7149,124,82543,1788,12312,18352,0.0194381646744096,0.000142001299912397,0.00289936982507701,0.00432173773796404
"40150","2020/08/19","PA",4246440,247,21,6326,129,82790,1809,11372,17534,0.0194963310443572,5.81663699475325e-05,0.00267800793134955,0.00412910579214589
"40149","2020/08/20","PA",4246440,964,18,6377,124,83754,1827,11194,17371,0.0197233447311159,0.000227013686758791,0.00263609046636712,0.00409072069780805
"40148","2020/08/21","PA",4246440,101,17,5409,122,83855,1844,10204,16402,0.0197471293601228,2.37846290068858e-05,0.00240295400382438,0.00386252955416773
"40147","2020/08/22","PA",4246440,537,15,4990,125,84392,1859,9900,15936,0.019873588229199,0.000126458869076214,0.00233136462542742,0.00375279057280922
"40146","2020/08/23","PA",4246440,1088,19,4815,132,85480,1878,10086,16056,0.0201298028466198,0.00025621461742071,0.0023751660214203,0.00378104953796592
"40145","2020/08/24","PA",4246440,1420,14,4960,125,86900,1892,10436,16669,0.020464200600974,0.000334397754354236,0.00245758800312733,0.00392540575164137
"40144","2020/08/25","PA",4246440,585,14,4942,118,87485,1906,10108,16067,0.0206019630561129,0.000137762455138893,0.00238034683169902,0.00378363994310528
"40143","2020/08/26","PA",4246440,896,13,5591,110,88381,1919,9935,15821,0.0208129633292829,0.000211000273169997,0.00233960682359812,0.00372570906453406
"40142","2020/08/27","PA",4246440,701,13,5328,105,89082,1932,9680,15431,0.0209780427840732,0.000165079454790366,0.00227955652264014,0.0036338674277748
"40141","2020/08/28","PA",4246440,900,16,6127,104,89982,1948,9317,15490,0.0211899850227485,0.00021194223867522,0.00219407315304114,0.00364776141897684
"40140","2020/08/29","PA",4246440,642,18,6232,107,90624,1966,8684,15230,0.0213411704863368,0.000151185463588323,0.00204500711183956,0.00358653366113733
"40139","2020/08/30","PA",4246440,713,17,5857,105,91337,1983,8794,14873,0.0215090758376428,0.000167905351306035,0.0020709111632332,0.00350246323979616
"40138","2020/08/31","PA",4246440,728,12,5165,103,92065,1995,9275,14688,0.0216805135595934,0.000171437721950622,0.00218418251523629,0.00345889733517959
"40137","2020/09/01","PA",4246440,917,7,5497,96,92982,2002,9228,14536,0.0218964591516659,0.000215945592072418,0.00217311442054992,0.0034231026459811
"40136","2020/09/02","PA",4246440,570,16,5171,99,93552,2018,9697,14150,0.0220306892361602,0.000134230084494306,0.00228355987603734,0.00333220297472707
"40135","2020/09/03","PA",4246440,532,12,5002,98,94084,2030,9692,13419,0.0221559706483549,0.000125281412194685,0.00228238241915581,0.00316005877864753
"40134","2020/09/04","PA",4246440,830,16,4932,98,94914,2046,9434,12974,0.0223514284906887,0.000195457842333814,0.00222162564406891,0.00305526511619145
"40133","2020/09/05","PA",4246440,682,17,4972,97,95596,2063,8696,13053,0.0225120336093292,0.000160605118640555,0.00204783300835523,0.0030738689349196
"40132","2020/09/06","PA",4246440,709,12,4968,92,96305,2075,8820,13515,0.02267899699513,0.000166963385800812,0.00207703393901715,0.00318266595077288
"40131","2020/09/07","PA",4246440,738,11,4978,91,97043,2086,8662,13289,0.0228527896308437,0.00017379263571368,0.00203982630156084,0.00312944489972777
"40130","2020/09/08","PA",4246440,535,13,4596,97,97578,2099,8496,13723,0.0229787775171673,0.000125987886323603,0.00200073473309407,0.00323164815704449
"40129","2020/09/09","PA",4246440,829,8,4855,89,98407,2107,8425,14015,0.0231739998681248,0.000195222350957508,0.00198401484537636,0.00330041163892578
"40128","2020/09/10","PA",4246440,635,9,4958,86,99042,2116,8418,13562,0.023323536892079,0.000149537023954183,0.00198236640574222,0.00319373404545926
"40127","2020/09/11","PA",4246440,673,11,4801,81,99715,2127,8378,12815,0.0234820225883328,0.000158485696253803,0.00197294675068999,0.00301782198735882
"40126","2020/09/12","PA",4246440,615,13,4734,77,100330,2140,8265,12845,0.0236268497847609,0.000144827196428067,0.00194633622516743,0.003024886728648
"40125","2020/09/13","PA",4246440,711,15,4736,80,101041,2155,8059,12660,0.0237942841533143,0.000167434368553424,0.00189782500164844,0.00298132082403142
"40124","2020/09/14","PA",4246440,704,11,4702,80,101745,2166,8193,12663,0.0239600700822336,0.000165785928919283,0.00192938084607342,0.00298202729816034
"40123","2020/09/15","PA",4246440,459,7,4626,74,102204,2173,8120,12222,0.0240681606239579,0.000108090541724362,0.00191218997560309,0.00287817560120948
"40122","2020/09/16","PA",4246440,628,14,4425,80,102832,2187,7918,12208,0.024216049208278,0.000147888584320042,0.00186462071758932,0.0028748787219412
"40121","2020/09/17","PA",4246440,634,11,4424,82,103466,2198,7870,12129,0.0243653507408559,0.000149301532577877,0.00185331713152664,0.00285627490321304
"40120","2020/09/18","PA",4246440,672,15,4423,86,104138,2213,7833,12073,0.0245236009457334,0.000158250204877497,0.00184460395060333,0.00284308738613992
"40119","2020/09/19","PA",4246440,741,16,4549,89,104879,2229,7836,11897,0.024698100055576,0.000174499109842598,0.00184531042473225,0.0028016409039101
"40118","2020/09/20","PA",4246440,722,18,4560,92,105601,2247,8023,12049,0.0248681248292688,0.000170024773692787,0.00188934731210143,0.00283743559310858
"40117","2020/09/21","PA",4246440,602,10,4458,91,106203,2257,7796,12119,0.0250098906378048,0.000141765808536091,0.00183589076968001,0.00285391998944999
"40116","2020/09/22","PA",4246440,607,15,4606,99,106810,2272,7768,11896,0.0251528339032225,0.00014294326541762,0.00182929701114345,0.00280140541253379
"40115","2020/09/23","PA",4246440,474,13,4452,98,107284,2285,7569,11688,0.0252644568155914,0.000111622912368949,0.0017824342272586,0.00275242320626219
"40114","2020/09/24","PA",4246440,706,6,4524,93,107990,2291,7660,11685,0.0254307137272633,0.000166256911671895,0.00180386394250243,0.00275171673213327
"40113","2020/09/25","PA",4246440,736,6,4588,84,108726,2297,7685,11683,0.0256040353802244,0.000173321652961069,0.00180975122691007,0.00275124574938066
"40112","2020/09/26","PA",4246440,705,14,4552,82,109431,2311,7686,11853,0.02577005680052,0.000166021420295589,0.00180998671828638,0.00279127928335264
"40111","2020/09/27","PA",4246440,677,12,4507,76,110108,2323,7904,11701,0.025929484462279,0.000159427661759026,0.00186132383832104,0.00275548459415416
"40110","2020/09/28","PA",4246440,447,17,4352,83,110555,2340,7723,11513,0.0260347491074877,0.000105264645208692,0.00181869989920969,0.00271121221540867
"40109","2020/09/29","PA",4246440,722,8,4467,76,111277,2348,7811,11562,0.0262047738811805,0.000170024773692787,0.0018394231403246,0.00272275129284766
"40108","2020/09/30","PA",4246440,576,16,4569,79,111853,2364,7715,11523,0.0263404169139326,0.000135643032752141,0.00181681596819924,0.00271356712917173
"40107","2020/10/01","PA",4246440,742,8,4605,81,112595,2372,7716,11554,0.0265151515151515,0.000174734601218903,0.00181705145957555,0.00272086736183721
"40106","2020/10/02","PA",4246440,747,15,4616,90,113342,2387,7741,11597,0.0266910635732519,0.000175912058100432,0.0018229387439832,0.00273099349101836
"40105","2020/10/03","PA",4246440,620,19,4531,95,113962,2406,7759,11758,0.0268370682265615,0.000146004653309596,0.0018271775887567,0.00276890760260359
"40104","2020/10/04","PA",4246440,691,8,4545,91,114653,2414,7843,11821,0.0269997927675889,0.000162724541027308,0.00184695886436639,0.00278374355931086
"40103","2020/10/05","PA",4246440,633,9,4731,83,115286,2423,8002,11820,0.0271488588087904,0.000149066041201571,0.00188440199319901,0.00278350806793455
"40102","2020/10/06","PA",4246440,633,7,4642,82,115919,2430,7929,11781,0.027297924849992,0.000149066041201571,0.00186721112272869,0.00277432390425863
"40101","2020/10/07","PA",4246440,683,10,4749,76,116602,2440,7876,11723,0.0274587654600089,0.000160840610016861,0.00185473007978448,0.00276066540443289
"40100","2020/10/08","PA",4246440,698,8,4705,76,117300,2448,7869,11699,0.0276231384406703,0.000164372980661448,0.00185308164015034,0.00275501361140155
"40099","2020/10/09","PA",4246440,754,15,4712,76,118054,2463,7946,11851,0.0278006989384049,0.000177560497734573,0.00187121447612588,0.00279080830060003
"40098","2020/10/10","PA",4246440,787,11,4879,68,118841,2474,8286,12031,0.0279860306515575,0.000185331713152664,0.00195128154406986,0.00283319674833508
"40097","2020/10/11","PA",4246440,825,8,5013,68,119666,2482,8389,12382,0.0281803110370098,0.000194280385452285,0.00197553715582935,0.00291585422141841
"40096","2020/10/12","PA",4246440,647,9,5027,68,120313,2491,8460,12323,0.0283326739574797,0.000152362920469852,0.00199225704354707,0.00290196023021637
"40095","2020/10/13","PA",4246440,489,11,4883,72,120802,2502,8207,12076,0.0284478292404932,0.000115155283013536,0.0019326777253417,0.00284379386026884
"40094","2020/10/14","PA",4246440,494,9,4694,71,121296,2511,7954,11865,0.0285641619803883,0.000116332739895065,0.00187309840713633,0.00279410517986831
"40093","2020/10/15","PA",4246440,832,8,4828,71,122128,2519,8166,12020,0.0287600908054747,0.000195928825086425,0.00192302257891316,0.00283060634319571
"40092","2020/10/16","PA",4246440,755,10,4829,66,122883,2529,8230,12328,0.0289378867945856,0.000177795989110879,0.00193809402699673,0.0029031376870979
"40091","2020/10/17","PA",4246440,615,17,4657,72,123498,2546,8212,12221,0.0290827139910136,0.000144827196428067,0.00193385518222323,0.00287794010983318
"40090","2020/10/18","PA",4246440,609,11,4441,75,124107,2557,8188,12254,0.0292261282391839,0.000143414248170232,0.00192820338919189,0.00288571132525127
"40089","2020/10/19","PA",4246440,638,7,4432,73,124745,2564,8143,12150,0.029376371737267,0.0001502434980831,0.00191760627725813,0.00286122022211547
"40088","2020/10/20","PA",4246440,436,10,4379,72,125181,2574,7881,11839,0.0294790459773363,0.000102674240069329,0.00185590753666601,0.00278798240408436
"40087","2020/10/21","PA",4246440,558,11,4443,74,125739,2585,7685,11777,0.0296104501653149,0.000131404187978636,0.00180975122691007,0.0027733819387534
"40086","2020/10/22","PA",4246440,696,12,4307,78,126435,2597,7594,11782,0.0297743521632238,0.000163901997908837,0.00178832151166624,0.00277455939563493
"40085","2020/10/23","PA",4246440,792,15,4344,83,127227,2612,7561,11941,0.029960861333258,0.000186509170034193,0.00178055029624815,0.00281200252446755
"40084","2020/10/24","PA",4246440,639,10,4368,76,127866,2622,7553,11947,0.0301113403227174,0.000150478989459406,0.00177866636523771,0.00281341547272539
"40083","2020/10/25","PA",4246440,649,6,4408,71,128515,2628,7713,11913,0.0302641742259398,0.000152833903222464,0.00181634498544663,0.00280540876593099
"40082","2020/10/26","PA",4246440,685,5,4455,69,129200,2633,7904,11900,0.0304254858187093,0.000161311592769473,0.00186132383832104,0.00280234737803902
"40081","2020/10/27","PA",4246440,551,5,4570,64,129751,2638,7623,11697,0.0305552415670538,0.000129755748344496,0.00179515076157911,0.00275454262864894
"40080","2020/10/28","PA",4246440,671,12,4683,65,130422,2650,7539,11581,0.030713256280555,0.000158014713501192,0.00177536948596942,0.00272722562899747
"40079","2020/10/29","PA",4246440,825,13,4812,66,131247,2663,7749,11581,0.0309075366660073,0.000194280385452285,0.00182482267499364,0.00272722562899747
"40078","2020/10/30","PA",4246440,798,15,4818,66,132045,2678,7938,11732,0.0310954587842993,0.000187922118292028,0.00186933054511544,0.00276278482681964
"40077","2020/10/31","PA",4246440,822,10,5001,66,132867,2688,8122,12065,0.0312890326956227,0.000193573911323367,0.0019126609583557,0.00284120345512947
"40076","2020/11/01","PA",4246440,731,12,5083,72,133598,2700,8417,12302,0.0314611768917022,0.00017214419607954,0.00198213091436592,0.00289701491131395
"40075","2020/11/02","PA",4246440,738,6,5136,73,134336,2706,8597,12208,0.0316349695274159,0.00017379263571368,0.00202451936210096,0.0028748787219412
"40074","2020/11/03","PA",4246440,579,14,5164,82,134915,2720,8480,12032,0.031771319034297,0.000136349506881058,0.00199696687107318,0.00283343223971138
"40073","2020/11/04","PA",4246440,677,11,5170,81,135592,2731,8365,12094,0.031930746696056,0.000159427661759026,0.00196988536279801,0.00284803270504234
"40072","2020/11/05","PA",4246440,432,13,4777,81,136024,2744,8158,11917,0.0320324789706201,0.000101732274564105,0.00192113864790271,0.00280635073143621
"40071","2020/11/06","PA",4246440,543,12,4522,78,136567,2756,8052,11822,0.0321603507879541,0.000127871817334049,0.0018961765620143,0.00278397905068716
"40070","2020/11/07","PA",4246440,1193,14,4893,82,137760,2770,8560,12579,0.032441291999887,0.000280941211932819,0.00201580618117765,0.00296224602255065
"40069","2020/11/08","PA",4246440,746,11,4908,81,138506,2781,8755,12767,0.0326169685666111,0.000175676566724127,0.00206172699955728,0.00300651840129614
"40068","2020/11/09","PA",4246440,1021,17,5191,92,139527,2798,9105,13092,0.0328574052618193,0.000240436695208221,0.00214414898126431,0.00308305309859553
"40067","2020/11/10","PA",4246440,804,10,5416,88,140331,2808,9084,13104,0.0330467403283692,0.000189335066549863,0.00213920366236188,0.0030858789951112
"40066","2020/11/11","PA",4246440,971,9,5710,86,141302,2817,9257,13436,0.0332754024547621,0.000228662126392931,0.00217994367046279,0.00316406213204472
"40065","2020/11/12","PA",4246440,1163,6,6441,79,142465,2823,9598,13950,0.0335492789254058,0.000273876470643645,0.00226024622978307,0.00328510469946591
"40064","2020/11/13","PA",4246440,887,7,6785,74,143352,2830,9754,14152,0.033758159776189,0.000208880850783244,0.00229698288448677,0.00333267395747968
"40063","2020/11/14","PA",4246440,1125,26,6717,86,144477,2856,10141,14726,0.034023087574533,0.000264927798344025,0.00238811804711711,0.00346784600747921
"40062","2020/11/15","PA",4246440,832,11,6803,86,145309,2867,10394,14887,0.0342190163996194,0.000195928825086425,0.00244769736532248,0.00350576011906444
"40061","2020/11/16","PA",4246440,1344,6,7126,75,146653,2873,11061,15406,0.0345355168093744,0.000316500409754995,0.00260477011331845,0.00362798014336715
"40060","2020/11/17","PA",4246440,1014,8,7336,73,147667,2881,11643,15622,0.0347743050649485,0.000238788255574081,0.00274182609432843,0.0036788462806492
"40059","2020/11/18","PA",4246440,1054,12,7419,76,148721,2893,12154,15854,0.0350225129755748,0.000248207910626313,0.00286216218762069,0.00373348027995215
"40058","2020/11/19","PA",4246440,1112,14,7368,84,149833,2907,12073,16235,0.0352843793860269,0.000261866410452049,0.00284308738613992,0.00382320249432466
"40057","2020/11/20","PA",4246440,1256,15,7737,92,151089,2922,12583,16753,0.035580156554667,0.000295777168640084,0.00296318798805588,0.00394518702725106
"40056","2020/11/21","PA",4246440,1200,10,7812,76,152289,2932,12762,17374,0.0358627462062339,0.00028258965156696,0.00300534094441462,0.00409142717193696
"40055","2020/11/22","PA",4246440,1288,14,8268,79,153577,2946,13246,17985,0.0361660590989158,0.00030331289268187,0.00311931877054662,0.00423531240285981
"40054","2020/11/23","PA",4246440,1206,11,8130,84,154783,2957,13481,18759,0.0364500616987406,0.000284002599824794,0.00317465924397849,0.0044175827281205
"40053","2020/11/24","PA",4246440,875,16,7991,92,155658,2973,13193,19091,0.0366561166530082,0.000206054954267575,0.00310683772760242,0.00449576586505402
"40052","2020/11/25","PA",4246440,1272,13,8209,93,156930,2986,13578,19170,0.0369556616836691,0.000299545030660977,0.00319750190748015,0.00451436968378218
