"","date","countrycode","population","cases","deaths","cases_prev_week","deaths_prev_week","cases_infected","cum_deaths","cases_contagious","cases_active","p_cases_infected","p_cases","p_cases_contagious","p_cases_active"
"41084","2020/03/07","PE",32510462,1,0,1,0,1,0,1,1,3.07593291045818e-08,3.07593291045818e-08,3.07593291045818e-08,3.07593291045818e-08
"41083","2020/03/09","PE",32510462,6,0,7,0,7,0,7,7,2.15315303732072e-07,1.84555974627491e-07,2.15315303732072e-07,2.15315303732072e-07
"41082","2020/03/10","PE",32510462,2,0,9,0,9,0,9,9,2.76833961941236e-07,6.15186582091636e-08,2.76833961941236e-07,2.76833961941236e-07
"41081","2020/03/11","PE",32510462,2,0,11,0,11,0,11,11,3.383526201504e-07,6.15186582091636e-08,3.383526201504e-07,3.383526201504e-07
"41080","2020/03/12","PE",32510462,6,0,17,0,17,0,17,17,5.2290859477789e-07,1.84555974627491e-07,5.2290859477789e-07,5.2290859477789e-07
"41079","2020/03/13","PE",32510462,5,0,22,0,22,0,22,22,6.76705240300799e-07,1.53796645522909e-07,6.76705240300799e-07,6.76705240300799e-07
"41078","2020/03/14","PE",32510462,16,0,38,0,38,0,38,38,1.16885450597411e-06,4.92149265673309e-07,1.16885450597411e-06,1.16885450597411e-06
"41077","2020/03/15","PE",32510462,5,0,42,0,43,0,43,43,1.32265115149702e-06,1.53796645522909e-07,1.32265115149702e-06,1.32265115149702e-06
"41076","2020/03/16","PE",32510462,28,0,64,0,71,0,71,71,2.18391236642531e-06,8.6126121492829e-07,2.18391236642531e-06,2.18391236642531e-06
"41075","2020/03/17","PE",32510462,15,0,77,0,86,0,86,86,2.64530230299403e-06,4.61389936568727e-07,2.64530230299403e-06,2.64530230299403e-06
"41074","2020/03/18","PE",32510462,31,0,106,0,117,0,117,117,3.59884150523607e-06,9.53539202242035e-07,3.59884150523607e-06,3.59884150523607e-06
"41073","2020/03/19","PE",32510462,28,0,128,0,145,0,145,145,4.46010272016436e-06,8.6126121492829e-07,4.46010272016436e-06,4.46010272016436e-06
"41072","2020/03/20","PE",32510462,89,2,212,2,234,2,233,234,7.19768301047214e-06,2.73758029030778e-06,7.16692368136755e-06,7.19768301047214e-06
"41071","2020/03/21","PE",32510462,29,1,225,3,263,3,256,263,8.08970355450501e-06,8.92020544032872e-07,7.87438825077294e-06,8.08970355450501e-06
"41070","2020/03/22","PE",32510462,55,2,275,5,318,5,309,318,9.78146665525701e-06,1.691763100752e-06,9.50463269331577e-06,9.78146665525701e-06
"41069","2020/03/23","PE",32510462,45,0,292,5,363,5,352,363,1.11656364649632e-05,1.38416980970618e-06,1.08272838448128e-05,1.11656364649632e-05
"41068","2020/03/24","PE",32510462,32,0,309,5,395,5,378,395,1.21499349963098e-05,9.84298531346617e-07,1.16270264015319e-05,1.21499349963098e-05
"41067","2020/03/25","PE",32510462,21,2,299,7,416,7,394,416,1.2795880907506e-05,6.45945911196217e-07,1.21191756672052e-05,1.2795880907506e-05
"41066","2020/03/26","PE",32510462,142,1,413,8,558,8,520,557,1.71637056403566e-05,4.36782473285061e-06,1.59948511343825e-05,1.71329463112521e-05
"41065","2020/03/27","PE",32510462,22,1,346,7,580,9,537,573,1.78404108806574e-05,6.76705240300799e-07,1.65177597291604e-05,1.76250955769254e-05
"41064","2020/03/28","PE",32510462,55,2,372,8,635,11,564,626,1.95321739814094e-05,1.691763100752e-06,1.73482616149841e-05,1.92553400194682e-05
"41063","2020/03/29","PE",32510462,36,5,353,11,671,16,585,660,2.06395098291744e-05,1.10733584776494e-06,1.79942075261803e-05,2.0301157209024e-05
"41062","2020/03/30","PE",32510462,181,2,489,13,852,18,735,835,2.62069483971037e-05,5.5674385679293e-06,2.26081068918676e-05,2.56840398023258e-05
"41061","2020/03/31","PE",32510462,98,6,555,19,950,24,805,928,2.92213626493527e-05,3.01441425224901e-06,2.47612599291883e-05,2.85446574090519e-05
"41060","2020/04/01","PE",32510462,115,6,649,23,1065,30,831,1027,3.27586854963796e-05,3.5373228470269e-06,2.55610024859075e-05,3.15898309904055e-05
"41059","2020/04/02","PE",32510462,258,17,765,39,1323,47,1060,1280,4.06945924053617e-05,7.9359069089821e-06,3.26048888508567e-05,3.93719412538647e-05
"41058","2020/04/03","PE",32510462,91,8,834,46,1414,55,1096,1343,4.34936913538786e-05,2.79909894851694e-06,3.37122246986216e-05,4.13097789874533e-05
"41057","2020/04/04","PE",32510462,181,6,960,50,1595,61,1232,1509,4.90611299218079e-05,5.5674385679293e-06,3.78954934568448e-05,4.64158276188139e-05
"41056","2020/04/05","PE",32510462,151,12,1075,57,1746,73,1351,1629,5.37057886165998e-05,4.64465869479185e-06,4.155585362029e-05,5.01069471113637e-05
"41055","2020/04/06","PE",32510462,535,10,1429,65,2281,83,1865,2136,7.0162029687551e-05,1.64562410709513e-05,5.7366148780045e-05,6.57019269673867e-05
"41054","2020/04/07","PE",32510462,280,9,1611,68,2561,92,2003,2327,7.87746418368339e-05,8.6126121492829e-06,6.16109361964773e-05,7.15769588263618e-05
"41053","2020/04/08","PE",32510462,393,15,1889,77,2954,107,2374,2691,9.08630581749346e-05,1.20884163381006e-05,7.30226472942771e-05,8.27733546204296e-05
"41052","2020/04/09","PE",32510462,1388,14,3019,74,4342,121,3707,4024,0.000133557006972094,4.26939487971595e-05,0.000114024832990685,0.000123775540316837
"41051","2020/04/10","PE",32510462,914,17,3842,83,5256,138,4585,4893,0.000161671033773682,2.81140268015877e-05,0.000141031523944507,0.000150505397308719
"41050","2020/04/11","PE",32510462,641,31,4302,108,5897,169,5045,5502,0.000181387763729719,1.97167299560369e-05,0.000155180815332615,0.000169237828733409
"41049","2020/04/12","PE",32510462,951,12,5102,108,6848,181,5898,6432,0.000210639885708176,2.92521219784573e-05,0.000181418523058823,0.00019784400480067
"41048","2020/04/13","PE",32510462,671,12,5238,110,7519,193,6454,6961,0.00023127939553735,2.06395098291744e-05,0.000198520710040971,0.000214115689896994
"41047","2020/04/14","PE",32510462,0,0,4958,101,7519,193,6196,6939,0.00023127939553735,0,0.000190584803131989,0.000213438984656693
"41046","2020/04/15","PE",32510462,2784,37,7349,123,10303,230,8889,9668,0.000316913367764506,8.56339722271557e-05,0.000273419676410627,0.000297381193783097
"41045","2020/04/16","PE",32510462,1172,24,7133,133,11475,254,9880,10804,0.000352963301475076,3.60499337105698e-05,0.000303902171553268,0.000332323791645902
"41044","2020/04/17","PE",32510462,1016,20,7235,136,12491,274,10745,11639,0.000384214779845331,3.12514783702551e-05,0.000330508991228731,0.000358007831448227
"41043","2020/04/18","PE",32510462,998,26,7592,131,13489,300,11208,12539,0.000414912590291704,3.06978104463726e-05,0.000344750560604153,0.000385691227642351
"41042","2020/04/19","PE",32510462,931,48,7572,167,14420,348,11859,13355,0.000443549525688069,2.86369353963656e-05,0.000364774883851235,0.00041079084019169
"41041","2020/04/20","PE",32510462,1208,52,8109,207,15628,400,12674,14305,0.000480706795246404,3.71572695583348e-05,0.000389843737071469,0.000440012202841042
"41040","2020/04/21","PE",32510462,697,45,8806,252,16325,445,11983,14911,0.000502146047632298,2.14392523858935e-05,0.000368589040660203,0.000458652356278419
"41039","2020/04/22","PE",32510462,1512,39,7534,254,17837,484,12581,16242,0.000548654153238425,4.65081056061277e-05,0.000386983119464743,0.000499593023316617
"41038","2020/04/23","PE",32510462,1413,46,7775,276,19250,530,13353,17504,0.000592117085263199,4.34629320247741e-05,0.000410729321533481,0.000538411296646599
"41037","2020/04/24","PE",32510462,1664,42,8423,298,20914,572,14066,18633,0.000643300608893223,5.11835236300241e-05,0.000432660723185047,0.000573138579205672
"41036","2020/04/25","PE",32510462,734,62,8159,334,21648,634,14129,19087,0.000665877956455986,2.2577347562763e-05,0.000434598560918636,0.000587103314619152
"41035","2020/04/26","PE",32510462,3683,66,10911,352,25331,700,17812,22377,0.000779164565548161,0.000113286609092175,0.000547885170010811,0.000688301507373227
"41034","2020/04/27","PE",32510462,2186,28,11889,328,27517,728,17214,23175,0.000846404458970777,6.72398934226158e-05,0.000529491091206271,0.000712847451998683
"41033","2020/04/28","PE",32510462,1182,54,12374,337,28699,782,17224,23443,0.000882761985972393,3.63575270016157e-05,0.000529798684497317,0.000721090952198711
"41032","2020/04/29","PE",32510462,2491,72,13353,370,31190,854,18699,25293,0.000959383474771906,7.66214887995132e-05,0.000575168694926575,0.000777995711042187
"41031","2020/04/30","PE",32510462,2741,89,14681,413,33931,943,20442,27083,0.00104369479584756,8.43113210756587e-05,0.000628782205555861,0.000833054910139388
"41030","2020/05/01","PE",32510462,3045,108,16062,479,36976,1051,22556,29457,0.00113735695297102,9.36621571234515e-05,0.000693807427282947,0.000906077557433666
"41029","2020/05/02","PE",32510462,3483,73,18811,490,40459,1124,24831,32940,0.00124449169624227,0.000107134743271258,0.00076378490099587,0.00101321230070492
"41028","2020/05/03","PE",32510462,2075,76,17203,500,42534,1200,26209,32231,0.00130831730413428,6.38256078920072e-05,0.000806171256501984,0.000991403936369775
"41027","2020/05/04","PE",32510462,3394,86,18411,558,45928,1286,28091,34453,0.00141271446711523,0.000104397162980951,0.000864060313876807,0.00105975116564016
"41026","2020/05/05","PE",32510462,1444,58,18673,562,47372,1344,28122,34881,0.00145713093834225,4.44164712270161e-05,0.000865013853079049,0.00107291615849692
"41025","2020/05/06","PE",32510462,3817,100,19999,590,51189,1444,30275,37700,0.00157453929753444,0.000117408359192189,0.000931238688641213,0.00115962670724273
"41024","2020/05/07","PE",32510462,3628,89,20886,590,54817,1533,33169,40397,0.00168613414352586,0.000111594845991423,0.00102025618706987,0.00124258461783779
"41023","2020/05/08","PE",32510462,3709,94,21550,576,58526,1627,33195,42898,0.00180022049517475,0.000114086351648894,0.00102105592962659,0.00131951369992835
"41022","2020/05/09","PE",32510462,3321,87,21388,590,61847,1714,34330,45522,0.00190237222713107,0.000102151731956316,0.00105596776816029,0.00140022617949877
"41021","2020/05/10","PE",32510462,3168,100,22481,614,65015,1814,36316,47178,0.00199981778173438,9.74455546033151e-05,0.00111705579576199,0.00145116362849596
"41020","2020/05/11","PE",32510462,2292,75,21379,603,67307,1889,36117,48057,0.00207031816404209,7.05003823077014e-05,0.00111093468927018,0.00147820107877889
"41019","2020/05/12","PE",32510462,1515,72,21450,617,68822,1961,34891,47908,0.00211691854763553,4.66003835934414e-05,0.00107322375178796,0.0014736179387423
"41018","2020/05/13","PE",32510462,3237,96,20870,613,72059,2057,35083,50411,0.00221648649594706,9.95679483115312e-05,0.00107912954297604,0.00155060853949107
"41017","2020/05/14","PE",32510462,4247,112,21489,636,76306,2169,35847,50975,0.00234712136665422,0.000130634870707159,0.00110262967041194,0.00156795680110606
"41016","2020/05/15","PE",32510462,4298,98,22078,640,80604,2267,38070,53087,0.00247932496314571,0.000132203596491492,0.00117100765901143,0.00163292050417493
"41015","2020/05/16","PE",32510462,3891,126,22648,679,84495,2393,38567,55796,0.00259900951269164,0.000119684549545928,0.00118629504557641,0.00171624752671924
"41014","2020/05/17","PE",32510462,4046,130,23526,709,88541,2523,41169,57351,0.00272346175824878,0.000124452245557138,0.00126633081990653,0.00176407828347687
"41013","2020/05/18","PE",32510462,3732,125,24966,759,92273,2648,41084,58342,0.00283825557446707,0.000114793816218299,0.00126371627693264,0.00179456077861951
"41012","2020/05/19","PE",32510462,2660,141,26111,828,94933,2789,40116,57957,0.00292007538988526,8.18198154181875e-05,0.0012339412463594,0.00178271843691425
"41011","2020/05/20","PE",32510462,4550,125,27424,857,99483,2914,40957,59024,0.00306003033731111,0.000139954947425847,0.00125980984213636,0.00181553864106883
"41010","2020/05/21","PE",32510462,4537,110,27714,855,104020,3024,42173,61486,0.0031995854134586,0.000139555076147488,0.00129721318632753,0.00189126810932432
"41009","2020/05/22","PE",32510462,4749,124,28165,881,108769,3148,43754,62841,0.00334566146737626,0.000146076053917659,0.00134584368564187,0.00193294700026102
"41008","2020/05/23","PE",32510462,2929,96,27203,851,111698,3244,44391,64326,0.00343575554232358,9.009407494732e-05,0.00136543737828149,0.00197862460398133
"41007","2020/05/24","PE",32510462,4056,129,27213,850,115754,3373,46932,64565,0.00356051538117176,0.000124759838848184,0.00144359683353623,0.00198597608363732
"41006","2020/05/25","PE",32510462,4205,83,27686,808,119959,3456,47900,65142,0.00368985836005653,0.000129342978884766,0.00147337186410947,0.00200372421653067
"41005","2020/05/26","PE",32510462,4020,173,29046,840,123979,3629,47673,65453,0.00381351086305694,0.000123652503000419,0.00146638949640273,0.00201329036788219
"41004","2020/05/27","PE",32510462,5772,159,30268,874,129751,3788,49147,67904,0.00399105371064859,0.000177542847591646,0.00151172874750288,0.00208868148351752
"41003","2020/05/28","PE",32510462,6154,195,31885,959,135905,3983,51410,70890,0.00418034662195819,0.000189292911309596,0.00158133710926655,0.0021805288402238
"41002","2020/05/29","PE",32510462,5874,116,33010,951,141779,4099,53238,74472,0.0043610269211185,0.000180680299160313,0.00163756516286972,0.00229070875707641
"41001","2020/05/30","PE",32510462,6506,131,36587,986,148285,4230,56012,79463,0.00456114711627291,0.000200120195154409,0.00172289154180583,0.00244422856863738
"41000","2020/05/31","PE",32510462,7386,141,39917,998,155671,4371,60738,83612,0.00478833552103935,0.000227188404766441,0.00186826013115409,0.00257184902509229
"40999","2020/06/01","PE",32510462,8805,135,44517,1050,164476,4506,64993,88170,0.00505917141380519,0.000270835892765843,0.00199914107649408,0.00271205004715098
"40998","2020/06/02","PE",32510462,5563,128,46060,1005,170039,4634,66019,89435,0.00523028556161398,0.000171114147808788,0.00203070014815538,0.00275096059846827
"40997","2020/06/03","PE",32510462,0,0,40288,846,170039,4634,61270,85544,0.00523028556161398,0,0.00188462409423773,0.00263127604892234
"40996","2020/06/04","PE",32510462,8875,260,43009,911,178914,4894,67216,90373,0.00550327460741715,0.000272989045803163,0.00206751906509357,0.00277981284916837
"40995","2020/06/05","PE",32510462,4284,137,41419,932,183198,5031,67444,90925,0.00563504757330117,0.000131772965884028,0.00207453219212941,0.0027967919988341
"40994","2020/06/06","PE",32510462,4202,131,39115,932,187400,5162,67441,92467,0.00576429827419863,0.000129250700897453,0.0020744399141421,0.00284422288431336
"40993","2020/06/07","PE",32510462,4358,139,36087,930,191758,5301,67779,92275,0.00589834743043639,0.000134049156237767,0.00208483656737945,0.00283831709312528
"40992","2020/06/08","PE",32510462,4757,164,32039,959,196515,5465,66764,92495,0.00604466955898689,0.000146322128550496,0.0020536158483383,0.00284508414552829
"40991","2020/06/09","PE",32510462,3181,106,29657,937,199696,5571,63791,90927,0.00614251498486856,9.78454258816746e-05,0.00196216836291038,0.00279685351749231
"40990","2020/06/10","PE",32510462,4040,167,33697,1104,203736,5738,61957,92038,0.00626678267445107,0.00012426768958251,0.00190575575333257,0.0028310271321275
"40989","2020/06/11","PE",32510462,5087,165,29909,1009,208823,5903,60538,93069,0.00642325538160608,0.000156472707155008,0.00186210826533317,0.00286274000043432
"40988","2020/06/12","PE",32510462,5965,206,31590,1078,214788,6109,59117,94829,0.00660673477971491,0.00018347939810883,0.00181839925867556,0.00291687641965839
"40987","2020/06/13","PE",32510462,5961,199,33349,1146,220749,6308,56273,96770,0.00679009114050732,0.000183356360792412,0.00173091972670213,0.00297658027745038
"40986","2020/06/14","PE",32510462,4383,190,33374,1197,225132,6498,55093,95381,0.00692490927997271,0.000134818139465382,0.00169462371835872,0.00293385556932411
"40985","2020/06/15","PE",32510462,4604,190,33221,1223,229736,6688,59697,93831,0.0070665252311702,0.000141615951197495,0.00183623966955622,0.00288617860921201
"40984","2020/06/16","PE",32510462,3256,172,33296,1289,232992,6860,54078,91213,0.00716667760673472,0.000100152375564518,0.00166340299931757,0.00280565068561622
"40983","2020/06/17","PE",32510462,4164,196,33420,1318,237156,7056,53958,88871,0.0072947594531262,0.000128081846391479,0.00165971187982502,0.00273361233685329
"40982","2020/06/18","PE",32510462,3752,201,32085,1354,240908,7257,53508,85237,0.00741016845592659,0.000115409002800391,0.00164587018172796,0.00262183293488724
"40981","2020/06/19","PE",32510462,3480,204,29600,1352,244388,7461,52630,79912,0.00751721092121053,0.000107042465283945,0.00161886349077414,0.00245803950740534
"40980","2020/06/20","PE",32510462,3537,199,27176,1352,247925,7660,51410,77886,0.00762600666825344,0.000108795747042906,0.00158133710926655,0.00239572110663946
"40979","2020/06/21","PE",32510462,3413,201,26206,1363,251338,7861,51642,81299,0.00773098825848738,0.000104981590233938,0.00158847327361881,0.00250070269687339
"40978","2020/06/22","PE",32510462,3598,184,25200,1357,254936,8045,51200,76022,0.00784166032460566,0.000110672066118285,0.00157487765015459,0.00233838571718852
"40977","2020/06/23","PE",32510462,0,0,21944,1185,254936,8045,46113,71738,0.00784166032460566,0,0.00141840494299958,0.00220661275130449
"40976","2020/06/24","PE",32510462,5874,359,23654,1348,260810,8404,46022,73410,0.00802234062376597,0.000180680299160313,0.00141560584405106,0.00225804234956735
"40975","2020/06/25","PE",32510462,3879,182,23781,1329,264689,8586,43940,72931,0.00814165606136265,0.000119315437596673,0.00135156492085532,0.00224330863092625
"40974","2020/06/26","PE",32510462,3913,175,24214,1300,268602,8761,43470,72087,0.00826201731614888,0.000120361254786229,0.00133710803617617,0.00221734775716199
"40973","2020/06/27","PE",32510462,3762,178,24439,1279,272364,8939,42628,72668,0.00837773391224031,0.000115716596091437,0.00131120868107011,0.00223521892737175
"40972","2020/06/28","PE",32510462,3625,196,24651,1274,275989,9135,42997,72253,0.00848923648024442,0.000111502568004109,0.0013225588735097,0.00222245380579335
"40971","2020/06/29","PE",32510462,3430,182,24483,1272,279419,9317,42263,70596,0.00859474097907314,0.000105504498828716,0.00129998152594694,0.00217148559746706
"40970","2020/06/30","PE",32510462,2946,187,27429,1459,282365,9504,41457,67577,0.00868535796261524,9.06169835420979e-05,0.00127518950668865,0.00207862318290032
"40969","2020/07/01","PE",32510462,2848,173,24403,1273,285213,9677,40825,64464,0.00877296053190508,8.76025692898489e-05,0.00125574961069455,0.00198286939139776
"40968","2020/07/02","PE",32510462,3264,183,23788,1274,288477,9860,40552,63345,0.00887335898210244,0.000100398450197355,0.001247352313849,0.00194844970212973
"40967","2020/07/03","PE",32510462,3527,185,23402,1284,292004,10045,40666,62268,0.0089818471358543,0.00010848815375186,0.00125085887736692,0.0019153219046841
"40966","2020/07/04","PE",32510462,3595,181,23235,1287,295599,10226,40663,62607,0.00909242692398527,0.000110579788130971,0.00125076659937961,0.00192574931725055
"40965","2020/07/05","PE",32510462,3481,186,23091,1277,299080,10412,44144,61924,0.00919950014859832,0.000107073224613049,0.00135783982399266,0.00190474069547212
"40964","2020/07/06","PE",32510462,3638,177,23299,1272,302718,10589,41908,61810,0.00931140258788079,0.000111902439282469,0.00128906196411481,0.0019012341319542
"40963","2020/07/07","PE",32510462,2985,183,23338,1268,305703,10772,41014,61315,0.00940321918525796,9.18165973771766e-05,0.00126156312389532,0.00188600826404743
"40962","2020/07/08","PE",32510462,3575,180,24065,1275,309278,10952,40676,61353,0.00951318378680684,0.00010996460154888,0.00125116647065797,0.00188717711855341
"40961","2020/07/09","PE",32510462,3633,181,24434,1273,312911,11133,40547,61573,0.00962493242944379,0.000111748642636946,0.00124719851720348,0.00189394417095641
"40960","2020/07/10","PE",32510462,3537,181,24444,1269,316448,11314,40459,61512,0.0097337281764867,0.000108795747042906,0.00124449169624227,0.00189206785188103
"40959","2020/07/11","PE",32510462,3198,186,24047,1274,319646,11500,40227,64710,0.00983209651096315,9.83683344764525e-05,0.00123735553189001,0.00199043618635749
"40958","2020/07/12","PE",32510462,3064,182,23630,1270,322710,11682,40345,61900,0.00992634309533959,9.42465843764386e-05,0.00124098513272435,0.00190400247157361
"40957","2020/07/13","PE",32510462,3616,188,23608,1281,326326,11870,41113,61637,0.0100375688293818,0.000111225734042168,0.00126460829747667,0.00189591276801911
"40956","2020/07/14","PE",32510462,3797,184,24420,1282,330123,12054,41646,61521,0.0101543620019919,0.000116793172610097,0.00128100301988941,0.00189234468584298
"40955","2020/07/15","PE",32510462,3744,175,24589,1277,333867,12229,41863,61503,0.0102695249301594,0.000115162928167554,0.00128767779430511,0.00189179101791909
"40954","2020/07/16","PE",32510462,3857,188,24813,1284,337724,12417,42125,61735,0.0103881636625158,0.000118638732356372,0.00129573673853051,0.00189892718227136
"40953","2020/07/17","PE",32510462,3862,198,25138,1301,341586,12615,42506,62167,0.0105069561915177,0.000118792529001895,0.00130745604291935,0.00191221521244454
"40952","2020/07/18","PE",32510462,3951,184,25891,1299,345537,12799,42819,63172,0.0106284863008099,0.000121530109292203,0.00131708371292909,0.00194312833819464
"40951","2020/07/19","PE",32510462,3963,199,26790,1316,349500,12998,43797,64287,0.0107503855220513,0.000121899221241458,0.00134716633679337,0.00197742499014625
"40950","2020/07/20","PE",32510462,4090,189,27264,1317,353590,13187,44312,65113,0.0108761911780891,0.000125805656037739,0.00136300739128223,0.00200283219598663
"40949","2020/07/21","PE",32510462,4091,197,27558,1330,357681,13384,44770,65677,0.0110020275934559,0.000125836415366844,0.00137709516401213,0.00202018045760162
"40948","2020/07/22","PE",32510462,4406,195,28220,1350,362087,13579,45639,66488,0.0111375531974907,0.000135525604034787,0.00140382502100401,0.00204512627350543
"40947","2020/07/23","PE",32510462,4463,188,28826,1350,366550,13767,46904,67470,0.0112748320832845,0.000137278885793748,0.0014427355723213,0.00207533193468613
"40946","2020/07/24","PE",32510462,4546,3887,29510,5039,371096,17654,48386,68378,0.0114146639933939,0.000139831910109429,0.00148832089805429,0.00210326140551309
"40945","2020/07/25","PE",32510462,4865,189,30424,5044,375961,17843,49635,70258,0.0115643081294877,0.00014964413609379,0.00152673930010592,0.00216108894422971
"40944","2020/07/26","PE",32510462,3923,187,30384,5032,379884,18030,49761,70606,0.0116849769775649,0.000120668848077274,0.00153061497557309,0.0021717931907581
"40943","2020/07/27","PE",32510462,4913,199,31207,5042,384797,18229,50930,71886,0.0118360975614558,0.00015112058389081,0.00156657263129635,0.00221116513201197
"40942","2020/07/28","PE",32510462,4920,189,32036,5034,389717,18418,51993,73269,0.0119874334606503,0.000151335899194542,0.00159926979813452,0.0022537052841636
"40941","2020/07/29","PE",32510462,5288,194,32918,5033,395005,18612,53419,75359,0.0121500887929553,0.000162655332305028,0.00164313260143765,0.00231799228199218
"40940","2020/07/30","PE",32510462,5678,204,34133,5049,400683,18816,55146,77973,0.0123247402636111,0.000174651470655815,0.00169625396280127,0.00239839716827156
"40939","2020/07/31","PE",32510462,6809,205,36396,1367,407492,19021,57992,81166,0.0125341805354842,0.000209440271873097,0.00178379501343291,0.00249661170610248
"40938","2020/08/01","PE",32510462,7243,196,38774,1374,414735,19217,61145,84612,0.0127569703561887,0.000222789820704486,0.00188077917809965,0.00260260835419687
"40937","2020/08/02","PE",32510462,7448,191,42299,1378,422183,19408,64502,88316,0.0129860658393596,0.000229095483170925,0.00198403824590373,0.00271654090920024
"40936","2020/08/03","PE",32510462,6667,206,44053,1385,428850,19614,66763,91126,0.0131911382864999,0.000205072447140247,0.00205358508900919,0.00280297462398412
"40935","2020/08/04","PE",32510462,4250,197,43383,1393,433100,19811,66550,91514,0.0133218654351944,0.000130727148694473,0.00204703335190992,0.0028149092436767
"40934","2020/08/05","PE",32510462,6790,196,44885,1395,439890,20007,68794,94353,0.0135307212798145,0.00020885584462011,0.0021160572864206,0.0029022349790046
"40933","2020/08/06","PE",32510462,7734,221,46941,1412,447624,20228,71663,98124,0.0137686139311093,0.000237892651294835,0.00220430580162164,0.00301822840905798
"40932","2020/08/07","PE",32510462,7785,196,47917,1403,455409,20424,75525,101819,0.0140080753081885,0.000239461377079169,0.00232309833062354,0.00313188413009941
"40931","2020/08/08","PE",32510462,8466,225,49140,1432,463875,20649,79078,106194,0.0142684837883879,0.000260408480199389,0.00243238622693212,0.00326645619493196
"40930","2020/08/09","PE",32510462,7137,195,48829,1436,471012,20844,81295,108925,0.0144880131202073,0.0002195293318194,0.00250057965955698,0.00335045992271657
"40929","2020/08/10","PE",32510462,7012,228,49174,1458,478024,21072,83019,111474,0.0147036975358886,0.000215684415681327,0.00255360874293327,0.00342886545260415
"40928","2020/08/11","PE",32510462,5109,204,50033,1465,483133,21276,82450,112037,0.0148608469482839,0.000157149412395308,0.00253610668467277,0.00344618295489003
"40927","2020/08/12","PE",32510462,6547,225,49790,1494,489680,21501,82188,113719,0.0150622282759316,0.000201381327647697,0.00252804774044737,0.00349792014644394
"40926","2020/08/13","PE",32510462,8875,212,50931,1485,498555,21713,83820,118671,0.0153352173217348,0.000272989045803163,0.00257824696554604,0.00365024034416982
"40925","2020/08/14","PE",32510462,9441,3935,52587,5224,507996,25648,85813,123199,0.0156256161478111,0.000290398826076357,0.00263955030845148,0.00378951858635537
"40924","2020/08/15","PE",32510462,8300,208,52421,5207,516296,25856,87446,126579,0.0158809185793792,0.000255302431568029,0.00268978029287926,0.00389348511872886
"40923","2020/08/16","PE",32510462,9507,219,54791,5231,525803,26075,92703,130798,0.0161733475211764,0.000292428941797259,0.00285148208598204,0.00402325872822109
"40922","2020/08/17","PE",32510462,10143,206,57922,5209,535946,26281,96056,135263,0.0164853393962842,0.000311991875107773,0.00295461811646971,0.00416059913267305
"40921","2020/08/18","PE",32510462,5547,200,58360,5205,541493,26481,93869,134001,0.0166559613948273,0.000170621998543115,0.00288734746371799,0.00412178085934306
"40920","2020/08/19","PE",32510462,7828,177,59641,5157,549321,26658,93912,134586,0.016896745423058,0.000240784028230666,0.00288867011486948,0.00413977506686924
"40919","2020/08/20","PE",32510462,9099,176,59865,5121,558420,26834,94545,136237,0.0171766245585806,0.00027987913552259,0.00290814077019268,0.00419055871922091
"40918","2020/08/21","PE",32510462,8639,200,59063,1386,567059,27034,96047,138209,0.017442354402715,0.000265729844134482,0.00295434128250777,0.00425121611621514
"40917","2020/08/22","PE",32510462,9008,211,59771,1389,576067,27245,98043,142967,0.0177194344392891,0.000277080036574073,0.00301573690340051,0.00439756900409474
"40916","2020/08/23","PE",32510462,9169,208,59433,1378,585236,27453,102103,145346,0.018001466727849,0.00028203228855991,0.00314061977956511,0.00447074544803454
"40915","2020/08/24","PE",32510462,9090,210,58380,1382,594326,27663,104646,146702,0.0182810690294097,0.000279602301560648,0.00321884075347806,0.00451245509830036
"40914","2020/08/25","PE",32510462,6112,150,58945,1332,600438,27813,101883,145029,0.0184690700488969,0.000188001019487204,0.00313385272716211,0.00446099474070839
"40913","2020/08/26","PE",32510462,6944,188,58061,1343,607382,28001,99386,143507,0.0186826628301991,0.000213592781302216,0.00305704668238797,0.00441417904181122
"40912","2020/08/27","PE",32510462,5996,123,54958,1290,613378,28124,97082,142366,0.0188670957675102,0.000184432937311072,0.00298617718813101,0.00437908264730289
"40911","2020/08/28","PE",32510462,8619,153,54938,1243,621997,28277,96194,143973,0.0191322104250626,0.00026511465755239,0.00295886290388614,0.00442851288917395
"40910","2020/08/29","PE",32510462,7964,194,53894,1226,629961,28471,94015,146828,0.0193771777220514,0.000244967296988889,0.00289183832576726,0.00451633077376753
"40909","2020/08/30","PE",32510462,9474,136,54199,1154,639435,28607,97942,149755,0.0196685916059883,0.000291413883936808,0.00301263021116095,0.00460636333005664
"40908","2020/08/31","PE",32510462,7731,181,52840,1125,647166,28788,97845,148611,0.0199063919792958,0.000237800373307522,0.0030096465562378,0.004571174657561
"40907","2020/09/01","PE",32510462,4871,156,51599,1131,652037,28944,93617,144041,0.0200562206713642,0.000149828692068418,0.00287959611278363,0.00443060452355306
"40906","2020/09/02","PE",32510462,5092,124,49747,1067,657129,29068,90070,140833,0.0202128471751647,0.00015662650380053,0.00277049277244968,0.00433192859578557
"40905","2020/09/03","PE",32510462,6308,191,50059,1135,663437,29259,87370,137634,0.0204068770231564,0.000194029847991702,0.00268744258386731,0.00423352950198001
"40904","2020/09/04","PE",32510462,6708,146,48148,1128,670145,29405,84909,134199,0.02061321060279,0.000206333579633535,0.00261174387494093,0.00412787120650577
"40903","2020/09/05","PE",32510462,6703,149,46887,1083,676848,29554,82522,135355,0.020819390385778,0.000206179782988012,0.0025383213563683,0.00416342899095067
"40902","2020/09/06","PE",32510462,6854,133,44267,1080,683702,29687,83264,134381,0.0210302148274608,0.000210824441682804,0.0025611447785639,0.0041334694044028
"40901","2020/09/07","PE",32510462,6275,151,42811,1050,689977,29838,82595,131557,0.021223229617592,0.000193014790131251,0.00254056678739293,0.00404660505901146
"40900","2020/09/08","PE",32510462,1598,138,39538,1032,691575,29976,78197,124516,0.0212723830255011,4.91534079091217e-05,0.00240528725799098,0.0038300286227861
"40899","2020/09/09","PE",32510462,4615,147,39061,1055,696190,30123,74193,120123,0.0214143373293188,0.000141954303817645,0.00228212690425624,0.00369490289002968
"40898","2020/09/10","PE",32510462,6586,113,39339,977,702776,30236,72815,117540,0.0216169182708016,0.000202580941482776,0.00223974054875012,0.00361545154295254
"40897","2020/09/11","PE",32510462,7291,108,39922,939,710067,30344,70632,115741,0.0218411845393031,0.000224266268501506,0.00217259293331482,0.0035601155098934
"40896","2020/09/12","PE",32510462,6603,126,39822,916,716670,30470,69504,116232,0.0220442883893806,0.000203103850077553,0.00213789641008485,0.00357521834048375
"40895","2020/09/13","PE",32510462,6162,123,39130,906,722832,30593,70795,115450,0.0222338273753231,0.000189538985942433,0.00217760670395887,0.00355116454512397
"40894","2020/09/14","PE",32510462,6787,117,39642,872,729619,30710,72490,116241,0.0224425909419559,0.000208763566632797,0.00222974376679113,0.00357549517444569
"40893","2020/09/15","PE",32510462,4241,102,42285,836,733860,30812,70423,111863,0.0225730412566884,0.000130450314732531,0.00216616423353196,0.00344083083162583
"40892","2020/09/16","PE",32510462,4160,115,41830,804,738020,30927,67875,108059,0.0227010000657634,0.00012795880907506,0.00208778946297349,0.003323822343712
"40891","2020/09/17","PE",32510462,6380,124,41624,815,744400,31051,67552,104965,0.0228972445854507,0.000196244519687232,0.00207785419967271,0.00322865297946243
"40890","2020/09/18","PE",32510462,5698,95,40031,802,750098,31146,66396,102932,0.0230725112426886,0.000175266657237907,0.00204229641522781,0.00316611926339281
"40889","2020/09/19","PE",32510462,6314,137,39742,813,756412,31283,66435,104375,0.0232667256466549,0.000194214403966329,0.00204349602906289,0.00321050497529072
"40888","2020/09/20","PE",32510462,6453,86,40033,776,762865,31369,71290,105736,0.0234652155973668,0.000198489950711866,0.00219283257186564,0.00325236842220206
"40887","2020/09/21","PE",32510462,6030,0,39276,659,768895,31369,72705,105458,0.0236506943518674,0.000185478754500628,0.00223635702254862,0.00324381732871099
"40886","2020/09/22","PE",32510462,4001,105,39036,662,772896,31474,70120,102751,0.0237737624276148,0.000123068075747432,0.00215684415681327,0.00316055182482488
"40885","2020/09/23","PE",32510462,3650,112,38526,659,776546,31586,66479,99698,0.0238860339788466,0.000112271551231723,0.00204484943954349,0.00306664359306859
"40884","2020/09/24","PE",32510462,6149,284,38295,819,782695,31870,66025,98993,0.0240751730935106,0.000189139114664073,0.00203088470413001,0.00304495826604986
"40883","2020/09/25","PE",32510462,6235,68,38832,792,788930,31938,66098,98953,0.0242669575104777,0.000191784416967067,0.00203313013515465,0.00304372789288568
"40882","2020/09/26","PE",32510462,5654,99,38172,754,794584,32037,64965,103009,0.024440870757235,0.000173913246757305,0.00199827981527916,0.00316848773173386
"40881","2020/09/27","PE",32510462,5558,105,37277,773,800142,32142,66282,103952,0.0246118311083983,0.000170960351163266,0.00203878985170989,0.00319749377907949
"40880","2020/09/28","PE",32510462,5160,120,36407,893,805302,32262,67282,102526,0.0247705492465779,0.000158718138179642,0.00206954918081447,0.00315363097577635
"40879","2020/09/29","PE",32510462,3412,62,35818,850,808714,32324,64314,98647,0.0248755000774828,0.000104950830904833,0.00197825549203207,0.00303431553817968
"40878","2020/09/30","PE",32510462,3054,72,35222,810,811768,32396,61670,95098,0.0249694390685681,9.39389910853928e-05,0.00189692782587956,0.00292515067918752
"40877","2020/10/01","PE",32510462,3061,67,32134,593,814829,32463,58417,91997,0.0250635933749573,9.41543063891248e-05,0.00179686772830235,0.00282976599963421
"40876","2020/10/02","PE",32510462,3468,72,29367,597,818297,32535,55432,88678,0.025170266728292,0.00010667335333469,0.00170505113092518,0.0027276757863361
"40875","2020/10/03","PE",32510462,3267,74,26980,572,821564,32609,52669,87704,0.0252707574564766,0.000100490728184669,0.00162006310460922,0.00269771619978824
"40874","2020/10/04","PE",32510462,3421,56,24843,523,824985,32665,52089,86965,0.0253759851213434,0.000105227664866774,0.00160222269372856,0.00267498505557995
"40873","2020/10/05","PE",32510462,3184,77,22867,480,828169,32742,51623,83769,0.0254739228252124,9.79377038689884e-05,0.00158788884636583,0.00257667823976171
"40872","2020/10/06","PE",32510462,1830,92,21285,510,829999,32834,47304,79901,0.0255302123974738,5.62895722613847e-05,0.00145503930396314,0.00245770115478519
"40871","2020/10/07","PE",32510462,2930,80,21161,518,832929,32914,43999,76517,0.0256203372317502,9.01248342764246e-05,0.00135337972127249,0.00235361158509528
"40870","2020/10/08","PE",32510462,2733,95,20833,546,835662,33009,41078,72797,0.025704402478193,8.4065246442822e-05,0.00126353172095801,0.00223918688082624
"40869","2020/10/09","PE",32510462,2952,89,20317,563,838614,33098,38472,69719,0.0257952040177097,9.08015395167254e-05,0.00118337290931147,0.00214450966584234
"40868","2020/10/10","PE",32510462,4741,60,21791,549,843355,33158,38053,70459,0.0259410339969946,0.000145829979284822,0.00117048475041665,0.00216727156937973
"40867","2020/10/11","PE",32510462,2733,65,21103,558,846088,33223,37374,69542,0.0260250992434374,8.4065246442822e-05,0.00114959916595464,0.00213906526459083
"40866","2020/10/12","PE",32510462,3283,82,21202,563,849371,33305,37603,66676,0.0261260821208877,0.000100982877450342,0.00115664305231959,0.00205090902737709
"40865","2020/10/13","PE",32510462,1800,52,21172,523,851171,33357,36342,62241,0.026181448913276,5.53667923882472e-05,0.00111785553831871,0.00191449140279827
"40864","2020/10/14","PE",32510462,2803,62,21045,505,853974,33419,35677,59390,0.0262676673127561,8.62183994801427e-05,0.00109740058446416,0.00182679655552111
"40863","2020/10/15","PE",32510462,2977,93,21289,503,856951,33512,35387,56809,0.0263592378355005,9.157052274434e-05,0.00108848037902384,0.00174740672710219
"40862","2020/10/16","PE",32510462,2789,65,21126,479,859740,33577,34755,54438,0.0264450256043731,8.57877688726786e-05,0.00106904048302974,0.00167447635779522
"40861","2020/10/17","PE",32510462,2677,71,19062,490,862417,33648,34248,53703,0.0265273683283861,8.23427240129654e-05,0.00105344550317372,0.00165186825090336
"40860","2020/10/18","PE",32510462,3132,54,19461,479,865549,33702,35550,53781,0.0266237065471417,9.63382187555501e-05,0.00109349414966788,0.00165426747857351
"40859","2020/10/19","PE",32510462,3126,57,19304,454,868675,33759,35746,53846,0.0267198602099226,9.61536627809226e-05,0.00109952297817238,0.00165626683496531
"40858","2020/10/20","PE",32510462,2201,61,19705,463,870876,33820,35214,52579,0.0267875614932818,6.77012833591845e-05,0.00108315901508874,0.00161729476498981
"40857","2020/10/21","PE",32510462,3242,55,20144,456,874118,33875,35504,52554,0.0268872832382388,9.97217449570541e-05,0.00109207922052907,0.00161652578176219
"40856","2020/10/22","PE",32510462,2767,62,19934,425,876885,33937,33530,51900,0.0269723943018712,8.51110636323778e-05,0.00103136030487663,0.00159640918052779
"40855","2020/10/23","PE",32510462,2991,47,20136,407,879876,33984,33788,51707,0.027064395455223,9.20011533518041e-05,0.00103929621178561,0.00159047263001061
"40854","2020/10/24","PE",32510462,3240,49,20699,385,883116,34033,33745,53117,0.0271640556815218,9.9660226298845e-05,0.00103797356063411,0.00163384328404807
"40853","2020/10/25","PE",32510462,3098,62,20665,393,886214,34095,35043,53285,0.0272593480830878,9.52924015659944e-05,0.00107789916981186,0.00163901085133764
"40852","2020/10/26","PE",32510462,2501,54,20040,390,888715,34149,34741,53053,0.0273362771651784,7.6929082090559e-05,0.00106860985242228,0.00163187468698538
"40851","2020/10/27","PE",32510462,1859,48,19698,377,890574,34197,33623,51960,0.0273934587579838,5.71815928054175e-05,0.00103422092248335,0.00159825474027407
"40850","2020/10/28","PE",32510462,1923,60,18379,382,892497,34257,32757,49142,0.0274526089478519,5.91501898681108e-05,0.00100758334347879,0.00151157495085736
"40849","2020/10/29","PE",32510462,2431,58,18043,378,894928,34315,32511,48840,0.0275273848769052,7.47759290532383e-05,0.00100001654851906,0.00150228563346777
"40848","2020/10/30","PE",32510462,2666,47,17718,378,897594,34362,32045,48223,0.027609389248298,8.2004371392815e-05,0.000985682701156323,0.00148330712741025
"40847","2020/10/31","PE",32510462,2586,49,17064,378,900180,34411,31505,49009,0.0276889328733624,7.95436250644485e-05,0.000969072663439849,0.00150748396008645
"40846","2020/11/01","PE",32510462,2323,65,16289,381,902503,34476,31627,48529,0.0277603867948724,7.14539215099435e-05,0.000972825301590608,0.00149271948211625
"40845","2020/11/02","PE",32510462,2408,53,16196,380,904911,34529,30793,47960,0.0278344552593562,7.40684644838329e-05,0.000947172021117387,0.00147521742385574
"40844","2020/11/03","PE",32510462,1634,56,15971,388,906545,34585,29660,46805,0.0278847160031131,5.02607437568866e-05,0.000912321701241896,0.00143969039873995
"40843","2020/11/04","PE",32510462,2357,38,16405,366,908902,34623,29026,46485,0.0279572157418126,7.24997386994993e-05,0.000892820286589591,0.00142984741342648
"40842","2020/11/05","PE",32510462,2885,48,16859,356,911787,34671,28671,46238,0.0280459564062793,8.87406644667184e-05,0.000881900724757464,0.00142224985913765
"40841","2020/11/06","PE",32510462,2935,59,17128,368,914722,34730,28508,46047,0.0281362350372013,9.02786309219475e-05,0.000876886954113417,0.00141637482727868
"40840","2020/11/07","PE",32510462,2781,53,17323,372,917503,34783,28788,46627,0.0282217767314411,8.55416942398419e-05,0.0008854995662627,0.00143421523815933
"40839","2020/11/08","PE",32510462,2507,57,17507,364,920010,34840,29436,45892,0.0282988903695063,7.71136380651865e-05,0.000905431611522469,0.00141160713126747
"40838","2020/11/09","PE",32510462,2323,39,17422,350,922333,34879,29836,45448,0.0283703442910162,7.14539215099435e-05,0.000917735343164302,0.00139794998914503
"40837","2020/11/10","PE",32510462,1194,64,16982,358,923527,34943,28599,43651,0.0284070709299671,3.67266389508706e-05,0.000879686053061934,0.0013426754747441
"40836","2020/11/11","PE",32510462,1904,49,16529,369,925431,34992,27837,42315,0.0284656366925822,5.85657626151237e-05,0.000856247444284243,0.00130158101106038
"40835","2020/11/12","PE",32510462,2575,39,16219,360,928006,35031,27826,41792,0.0285448419650265,7.92052724442981e-05,0.000855909091664093,0.00128549388193868
"40834","2020/11/13","PE",32510462,2231,36,15515,337,930237,35067,27734,41522,0.0286134660282588,6.8624063232322e-05,0.000853079233386471,0.00127718886308044
"40833","2020/11/14","PE",32510462,2413,39,15147,323,932650,35106,27739,42076,0.0286876882893882,7.42222611293558e-05,0.000853233030031994,0.00129422953140438
"40832","2020/11/15","PE",32510462,2249,71,14889,337,934899,35177,28354,42402,0.0287568660205444,6.91777311562044e-05,0.000872150017431312,0.00130425707269248
"40831","2020/11/16","PE",32510462,2112,54,14678,352,937011,35231,28109,42083,0.0288218297236133,6.49637030688767e-05,0.000864613981800689,0.00129444484670812
"40830","2020/11/17","PE",32510462,1257,40,14741,328,938268,35271,26481,40674,0.0288604942002977,3.86644766844593e-05,0.00081453779401843,0.00125110495199976
"40829","2020/11/18","PE",32510462,1663,46,14500,325,939931,35317,25209,39751,0.0289116469645987,5.11527643009195e-05,0.000775411927397402,0.00122271409123623
"40828","2020/11/19","PE",32510462,2020,85,13945,371,941951,35402,24448,39448,0.0289737808093899,6.21338447912552e-05,0.000752004077948815,0.00121339401451754
"40827","2020/11/20","PE",32510462,1966,44,13680,379,943917,35446,23907,39006,0.0290342536504095,6.04728410196078e-05,0.000735363280903237,0.00119979839105332
"40826","2020/11/21","PE",32510462,2170,38,13437,378,946087,35484,23754,39542,0.0291010013945665,6.67477441569425e-05,0.000730657103550236,0.00121628539145337
"40825","2020/11/22","PE",32510462,1994,65,13182,372,948081,35549,24554,39179,0.029162335496801,6.13341022345361e-05,0.000755264566833901,0.00120511975498841
"40824","2020/11/23","PE",32510462,1589,46,12659,364,949670,35595,24239,37883,0.0292112120707482,4.88765739471804e-05,0.000745575378165958,0.00116525566446887
"40823","2020/11/24","PE",32510462,887,46,12289,370,950557,35641,22551,35835,0.0292384955956639,2.7283524915764e-05,0.000693653630637424,0.00110226055846269
"40822","2020/11/25","PE",32510462,1882,44,12508,368,952439,35685,22202,34936,0.0292963846530388,5.78890573748229e-05,0.000682918624779925,0.00107460792159767
